"abityé"	"abitje"	"habituer"
"abiyé"	"abije"	"habiller"
"abizé"	"abize"	"abuser"
"aboli"	"aboli"	"abolir"
"aboné"	"abone"	"abonner"
"abouti"	"abuti"	"bout > aboutir"
"abréjé"	"abʀeʒe"	"abréger"
"acharné"	"aʃaʀne"	"chair >  acharner"
"achté"	"aʃte"	"acheter"
"adapté"	"adapte"	"adapter"
"adisyonné"	"adisjɔ̃ne"	"addition > additionner"
"admèt"	"admεt"	"admettre"
"admiré"	"admiʀe"	"admirer"
"adòpté"	"adɔpte"	"adopter"
"adòpté 2"	"adɔpte"	"adopter"
"adoré"	"adoʀe"	"adorer"
"adosé"	"adose"	"dos > adosser"
"adrésé"	"adrese"	"adresser"
"afalé"	"afale"	"affaler"
"afiché 1"	"afiʃe"	"afficher"
"afiché 2"	"afiʃe"	"affiche > afficher"
"afolé"	"afole"	"affoler"
"agasé"	"agase"	"agacer"
"agrafé"	"agʀafe"	"agrafe > agrafer"
"agrandi"	"agʀãdi"	"grand  > agrandir"
"agravé"	"agʀave"	"aggraver"
"agripé"	"agʀipe"	"agripper"
"ajansé"	"aʒãse"	"agencer"
"aji"	"aʒi"	"agir"
"ajisté"	"aʒiste"	"juste  >  ajuster"
"ajouté"	"aʒute"	"ajouter"
"akablé"	"akable"	"accabler"
"akaparé"	"akapaʀe"	"accaparer"
"akizé"	"akize"	"accuser"
"akomodé"	"akomode"	"accommoder"
"akonpagné"	"akɔ̃paɲe"	"accompagner"
"akòrdé"	"akɔʀde"	"accorder"
"akòrdé 2"	"akɔʀde"	"accorder  > accord"
"akoré cf koré"	"akore"	"xxx"
"akòsté"	"akɔste"	"accoster"
"akouché"	"akuʃe"	"accoucher"
"akoudé"	"akude"	"coude >  accouder"
"akséléré"	"akseleʀe"	"accélérer"
"aksyonné"	"aksjɔ̃ne"	"action  > actionner"
"aktivé"	"aktive"	"activer"
"akwè"	"akwε"	"accroire"
"akwoupi"	"akwupi"	"croupe  > accroupir"
"alé"	"ale"	"aller"
"alé 2"	"ale"	"aller"
"alé vini"	"alevini"	"aller-venir"
"alé-vini"	"alevini"	"aller-venir"
"aligné"	"aliɲe"	"aligner"
"alimanté"	"alimɑ̃te"	"alimenter"
"alyansé"	"aljɑ̃se"	"allier"
"amadouwé"	"amaduwe"	"amadouer"
"amizé"	"amize"	"amuser"
"amòrti"	"amòrti"	"amortir"
"analizé"	"analize"	"analyser"
"anbaglé"	"ɑ̃bagle"	"xxx"
"anbaké var baké"	"ɑ̃bake"	"embarquer"
"anbalé"	"ɑ̃bale"	"emballer"
"anbarasé"	"ɑ̃baʀase"	"embarrasser"
"anbété"	"ɑ̃bete"	"embêter"
"anbobiné var bobiné"	"ɑ̃bobine"	"embobiner"
"anbomé"	"ɑ̃bɔ̃me"	"baume > embaumer"
"anbomé 2"	"ɑ̃bɔ̃me"	"baume > embaumer"
"anbwaré cf bwaré"	"ɑ̃bwaʀe"	"bras"
"anbwaté"	"ɑ̃bwate"	"emboîter"
"anchéné"	"ɑ̃ʃene"	"enchaîner"
"andété"	"ɑ̃dete"	"dette > endetter"
"andui"	"ɑdɥi"	"enduire"
"anèstézyé"	"anɛstezye"	"anesthésier"
"anfiyansé cf fiyansé"	"ɑ̃fijɑ̃se"	"fiancer"
"anfouné"	"ɑ̃fune"	"four > enfourner"
"angajé"	"ɑ̃gaʒe"	"engager.   gage > engager"
"angrésé"	"ɑ̃gʀese"	"engraisser"
"angwé"	"ɑ̃gwe"	"engouer"
"anilé"	"anile"	"annuler"
"animé"	"anime"	"animer"
"ankadré"	"ɑ̃kadʀe"	"cadre  >  encadrer"
"ankastré"	"ɑ̃kastʀe"	"encastrer"
"ankésé"	"ɑ̃kese"	"encaisser"
"ankilozé"	"ɑ̃kiloze"	"ankyloser"
"ankonbré"	"ɑ̃kɔ̃bʀe"	"encombrer"
"ankourajé"	"ɑ̃kuʀaʒe"	"courage  > encourager"
"ankrasé"	"ɑ̃kʀase"	"crasse  > encrasser"
"ankré"	"ɑ̃kʀe"	"ancre  > ancrer"
"ankréyé"	"ɑ̃kʀeje"	"xxx"
"anlédi"	"ɑ̃ledi"	"laid > enlaidir"
"anmagaziné"	"ɑ̃magazine"	"magasin > emmagasiner"
"anmanché v manché"	"ɑ̃mɑ̃ʃe"	"manche > emmancher"
"anmariné cf mariné"	"ɑ̃maʀine"	"mariner"
"anmayoté"	"ɑ̃majote"	"maillot > emmailloter"
"anmèkdé cf anmèrdé"	"ɑ̃mεkde"	"merde > emmerder"
"anménajé"	"ɑ̃menaʒe"	"aménager"
"anmerdé"	"ɑ̃mεʀde"	"merde > emmerder"
"anmidonné"	"ɑ̃midɔ̃ne"	"amidon > amidonner"
"anmizé"	"ɑ̃mize"	"amuser"
"annargé cf nargé"	"ɑ̃naʀge"	"narguer"
"annuyé"	"ɑ̃nɥje"	"ennuyer"
"annuyé 2"	"ɑ̃nɥje"	"ennuyer"
"anonsé"	"anɔ̃se"	"annoncer"
"anpakté"	"ɑ̃pakte"	"empaqueter"
"anpayé"	"ɑ̃paje"	"empailler"
"anpéché"	"ɑ̃peʃe"	"empêcher"
"anpèsté"	"ɑ̃pεste"	"peste > empester"
"anpifré"	"ɑ̃pifʀe"	"s'empiffrer"
"anpilé"	"ɑ̃pile"	"pile"
"anpiré"	"ɑ̃piʀe"	"empirer"
"anpwazonné"	"ɑ̃pwazɔ̃ne"	"poison > empoisonner"
"anrèjistré"	"ɑ̃ʀεʒistʀe"	"registre > enregistrer"
"anrichi"	"ɑ̃ʀiʃi"	"riche > enrichir"
"antamé"	"ɑ̃tame"	"entamer"
"antasé"	"ɑ̃tase"	"tas > entasser"
"antéré var téré"	"ɑ̃teʀe"	"terre > enterrer"
"antiché"	"ɑ̃tiʃe"	"enticher (s')"
"antonné"	"ɑ̃tɔ̃ne"	"entonner"
"antòtiyé var tòtiyé"	"ɑ̃tɔtije"	"entortiller"
"antouré"	"ɑ̃tuʀe"	"entourer"
"antré"	"ɑ̃tʀe"	"entrer"
"antrenné"	"ɑ̃tʀɛ̃ne"	"entraîner"
"antrenné 2"	"ɑ̃tʀɛ̃nε"	"entraîner"
"antrèprann"	"ɑ̃tʀεpʀɑ̃n"	"entreprendre"
"antrètyenn"	"ɑ̃tʀεtjɛ̃n"	"entretenir"
"anvalé var valé"	"ɑ̃vale"	"avaler"
"anvayi"	"ɑ̃vaji"	"envahir"
"anvi"	"ɑ̃vi"	"envie"
"anviwonné"	"ɑ̃viwɔ̃ne"	"environner"
"anvizajé"	"ɑ̃vizaʒe"	"visage > envisager"
"anvlimé"	"ɑ̃vlime"	"venin > envenimer"
"anvyé"	"ɑ̃vje"	"envier"
"anvyolé cf vyolé"	"ɑ̃vjole"	"violer > viol"
"anwoulé"	"ɑ̃wule"	"enrouler"
"aparéyé"	"apaʀeje"	"appareiller"
"apiyé"	"apije"	"appuyer"
"aplodi"	"aplodi"	"applaudir"
"aprann"	"apʀɑ̃n"	"apprendre"
"aprésyé"	"apʀesje"	"apprécier"
"aprivwazé"	"apʀivwaze"	"apprivoiser"
"aprouvé"	"apʀuve"	"approuver"
"aprovizyonné"	"apʀovisjɔ̃ne"	"provision > approvisonner"
"apwoché"	"apwoʃe"	"approcher"
"aranjé"	"aʀɑ̃ʒe"	"arranger"
"arbitré"	"aʀbitʀe"	"arbitrer"
"arèsté cf arété"	"aʀεste"	"arrêter"
"arété var arèsté"	"aʀete"	"arrêter"
"arimé"	"aʀime"	"arrimer"
"asasiné"	"asasine"	"assassiner"
"asèpté"	"asεpté"	"accepter"
"asézonné"	"asezɔ̃ne"	"assaisonner"
"asijéti"	"asiʒeti"	"assujettir"
"asiré"	"asiʀe"	"assurer"
"asiré 2"	"asiʀe"	"assurer"
"asòrti"	"asɔʀti"	"assortir"
"asosyé"	"asosje"	"associer"
"aspèrjé"	"aspεʀʒe"	"asperger"
"astiké"	"astike"	"astiquer"
"atablé"	"atable"	"table > attabler"
"ataké 1"	"atake"	"attaquer > attaque"
"ataké 2"	"atake"	"attaquer > attaque"
"atann"	"atɑ̃n"	"attendre"
"atéri"	"ateʀi"	"terre > atterrir"
"atiré"	"atiʀe"	"attirer"
"atlé"	"atle"	"atteler"
"avansé cf vansé"	"avãse"	"avancer"
"avantajé"	"avãtaʒe"	"avantage >avantager"
"avèti cf vèti"	"avεti"	"avertir"
"avizé"	"avize"	"aviser"
"avòté"	"avɔte"	"avorter"
"avwé"	"avwe"	"avouer"
"ay"	"aj"	"aller"
"azardé"	"azaʀde"	"hasard > hasarder"
"ba"	"ba"	"bailler"
"babyé"	"babje"	"babiller"
"baché"	"baʃe"	"bâcher"
"badijonné"	"badiʒɔ̃ne"	"badigeon >badigeonner"
"badiné"	"badine"	"badiner"
"bafouyé"	"bafuje"	"bafouiller"
"baké"	"bake"	"barque > embarquer"
"baklé"	"bakle"	"bacler"
"balansé"	"balɑ̃se"	"balancer > balance"
"baléyé"	"baleje"	"balai > balayer"
"balkoné"	"balkone"	"balcon"
"balonné"	"balɔ̃ne"	"ballonner"
"baloté"	"balote"	"ballotter"
"balyé cf baléyé"	"balje"	"balayer"
"bandé"	"bãde"	"bander"
"bandé 2"	"bãde"	"bander"
"bandoné cf abandoné"	"bɑ̃done"	"abandonner"
"baragwiné"	"baʀagwine"	"baragouin > baragouiner"
"barboté"	"baʀbote"	"barboter"
"bardé"	"bawde"	"barder"
"baré"	"baʀe"	"barrer"
"baré 2"	"baʀe"	"barrer"
"baré 3"	"baʀe"	"barrer"
"baré 4"	"baʀe"	"barrer"
"baré kous"	"baʀe-kous"	"barrer-course"
"barikadé"	"baʀikade"	"barricade > barricader"
"basé"	"base"	"basse"
"baskilé"	"baskile"	"basculer"
"bat"	"bat"	"battre"
"bat-aryè"	"bataʀjε"	"battre-arrière"
"bat-chat"	"batʃat"	"xxx"
"bat-dèyè"	"batdεjε"	"battre"
"batdous"	"batdus"	"battre"
"baté"	"bate"	"bâter"
"batifolé"	"batifole"	"batifoler"
"batizé"	"batize"	"baptiser"
"bat-men"	"batmɛ̃"	"battre-main"
"bat-zantricha"	"batzɑ̃tʀiʃa"	"battre"
"bavé"	"bave"	"bave > baver"
"bay"	"baj"	"bailler"
"bay filaj"	"bajfilaʒ"	"bailler"
"bay lanmen"	"bajlɑ̃mɛ̃"	"bailler-main"
"bayé"	"baje"	"bâiller"
"bazé"	"baze"	"base > baser"
"bégéyé"	"begeje"	"bégayer"
"bèkté"	"bεkte"	"bec > becqueter"
"bénéfisyé"	"benefisje"	"bénéficier"
"bénékaki"	"benekaki"	"xxx"
"bengné"	"bɛ̃ɲe"	"baigner"
"béni"	"beni"	"bénir"
"bèrsé"	"bεʀse"	"bercer"
"bésé"	"bese"	"baisser"
"bésé pyé"	"besepje"	"baisser-pied"
"bétizé"	"betize"	"bêtise > bêtiser"
"bétonné"	"betɔ̃ne"	"béton > betonner"
"bigidi"	"bigidi"	"xxx"
"biginé"	"bigine"	"biguine"
"bigòp 2"	"bigɔp"	"big up"
"biké"	"bike"	"xxx"
"bildozé"	"bildoze"	"bulldozer"
"bimé"	"bime"	"abimer"
"bipé"	"bipe"	"beep"
"bisé"	"bise"	"bis > bisser"
"bityé"	"bitje"	"xxx"
"blagé"	"blage"	"blaguer > blague (à vérifier***)"
"blanchi"	"blãʃi"	"blanc > blanchir"
"blanmé"	"blãme"	"blâmer"
"blasfémé"	"blasfeme"	"blasphémer"
"blenmi"	"blɛ̃mi"	"blêmir > bléme"
"blésé"	"blese"	"blesser"
"bloké"	"bloke"	"bloquer"
"blouzé"	"bluze"	"blouse > blouser"
"bo 2"	"bo"	"xxx"
"bobi"	"bobi"	"xxx"
"bobiné"	"bobine"	"bobine > embobiner"
"bòdé"	"bɔde"	"aborder"
"bokanté"	"bokɑ̃te"	"brocanter > brocante"
"boké"	"boke"	"xxx"
"bòksé"	"bɔkse"	"boxer"
"bonbansé"	"bɔ̃bɑ̃se"	"bombance > bombancer"
"bonbardé"	"bɔ̃bɑʀde"	"bombarder"
"bondaté"	"bɔ̃date"	"xxx"
"bòné"	"bɔne"	"borner"
"bouché"	"buʃe"	"boucher"
"bouchonné"	"buʃɔ̃ne"	"bouchon"
"boudé"	"bude"	"bouder"
"boudiné"	"budine"	"boudin > boudiner"
"boufi"	"bufi"	"bouffir"
"boufi 2"	"bufi"	"bouffir"
"boufté"	"bufte"	"bouffer"
"bougonné"	"bugɔ̃ne"	"bougonner"
"boujé"	"buʒe"	"bouger"
"boujonné"	"buʒɔ̃ne"	"bourgeon > bourgeonner"
"boukanné"	"bukãne"	"xxx"
"bouklé"	"bukle"	"boucler"
"boula 2"	"bula"	"xxx"
"boulvèsé"	"bulvεse"	"bouleverser"
"bouré"	"buʀe"	"bourrer"
"bouré 2"	"buʀe"	"bourrer"
"bouskilé"	"buskile"	"bousculer"
"bousouflé"	"busufle"	"boursoufler"
"bout 2"	"but"	"bout"
"boutonné"	"butɔ̃ne"	"bouton > boutonner"
"bouyi"	"buji"	"bouillir"
"bouyonné"	"bujɔ̃ne"	"bouillon > bouillonner"
"bouzen cf bouzwen"	"buzɛ̃"	"besoin"
"bouzwen var bouzen"	"buzwɛ̃"	"besoin"
"braké"	"bʀake"	"braquer"
"braké 2"	"bʀake"	"braquer"
"branché"	"bʀɑ̃ʃe"	"brancher"
"bréché"	"bʀeʃe"	"ébrécher"
"brenné cf branné"	"bʀɛ̃ne"	"xxx"
"bridé"	"bʀide"	"bride > brider"
"brikolé"	"bʀikole"	"bricoler"
"brilé"	"bʀile"	"brûler"
"britalizé"	"bʀitalize"	"brutal > brutaliser"
"briyé"	"bʀije"	"briller"
"brizé"	"bʀize"	"briser"
"brodé"	"bʀode"	"broder"
"brodé 2"	"bʀode"	"broder"
"bronzé"	"bʀɔ̃ze"	"bronze > bronzer"
"brosé"	"bʀose"	"brosse > brosser"
"bwanné"	"bwɑ̃ne"	"xxx"
"bwaré"	"bwaʀe"	"bras"
"bwasonné"	"bwasɔ̃ne"	"boisson > boissonner"
"bwazé"	"bwaze"	"boiser"
"bwè"	"bwε"	"boire"
"bwété"	"bwete"	"boiter"
"bwété 2"	"bwete"	"xxx"
"chaché cf chèché"	"ʃaʃe"	"chercher"
"chagriné"	"ʃagʀine"	"chagriner"
"chajé"	"ʃaʒe"	"charger > charge"
"chaléré"	"ʃaleʀe"	"xxx"
"chalviré"	"ʃalviʀe"	"chavirer"
"chanboulé"	"ʃɑ̃bule"	"chambouler"
"chanjé"	"ʃɑ̃ʒe"	"changer"
"chanté"	"ʃɑ̃te"	"chanter"
"chantyé"	"ʃɑ̃tje"	"chantier"
"chapé"	"ʃape"	"échapper"
"chapoté"	"ʃapote"	"chapeau > chapeauter"
"charmé"	"ʃaʀme"	"charme > charmer"
"chasé"	"ʃase"	"chasser"
"chasé 2"	"ʃase"	"chasser"
"chatouyé"	"ʃatuje"	"chatouiller"
"chayé"	"ʃaje"	"charrier"
"chayé 2"	"ʃaje"	"charrier"
"chèché"	"ʃεʃe"	"chercher"
"chifonné"	"ʃifɔ̃ne"	"chiffon > chiffonner"
"chifonné 3"	"ʃifɔ̃ne"	"chiffon > chiffonner"
"chigné"	"ʃiɲe"	"chigner"
"chikanné"	"ʃikɑ̃ne"	"chicaner"
"chiktayé"	"ʃiktaje"	"xxx"
"chiné"	"ʃine"	"chiner"
"chiré"	"ʃiʀe"	"déchirer"
"cho 3"	"ʃo"	"chaud"
"chodé"	"ʃode"	"échauder"
"chodé 2"	"ʃode"	"chaux >chauler"
"chofé"	"ʃofe"	"chauffer"
"chofé 2"	"ʃofe"	"chauffer"
"choké"	"ʃoke"	"choquer > choc"
"chomé"	"ʃome"	"chômer"
"chonjé"	"ʃɔ̃ʒe"	"songer"
"chosé"	"ʃose"	"chausser"
"chosé 2"	"ʃose"	"chausser (vocable agricole)"
"chouboulé"	"ʃubule"	"xxx"
"chouté"	"ʃute"	"ang shoot"
"chwazi"	"ʃwazi"	"choisir"
"chyé"	"ʃje"	"chier"
"chyé 2"	"ʃje"	"chier"
"danmé"	"dɑ̃me"	"damer"
"dansé"	"dɑ̃se"	"danser"
"dardé"	"daʀde"	"dard > darder"
"daté"	"daté"	"date > dater"
"débaché"	"debaʃe"	"bâcher > débâcher"
"débaglé"	"debagle"	"xxx"
"débaké"	"debake"	"débarquer"
"débalé"	"debale"	"déballer"
"débandé"	"debɑ̃de"	"bander > débander"
"débarasé"	"debaʀase"	"débarrasser"
"débaré"	"debaʀe"	"débarrer"
"débat"	"debat"	"débattre"
"débaté"	"debate"	"bâter > débâter"
"débatizé"	"debatize"	"baptiser > débaptiser"
"débawbouyé"	"debawbuje"	"débarbouiller"
"débité"	"debite"	"débiter"
"débité 2"	"debite"	"débuter"
"débloké"	"debloke"	"débloquer"
"débobiné"	"debobine"	"bobine > débobiner"
"débòdé"	"debɔde"	"déborder"
"débòdé 2"	"debɔde"	"déborder"
"débondaté"	"debɔ̃date"	"xxx"
"débouché"	"debuʃe"	"boucher > déboucher"
"débouchonné"	"debuʃɔ̃ne"	"bouchon"
"débouklé"	"debukle"	"boucler > déboucler"
"déboulé"	"debule"	"débouler"
"débousé"	"debuse"	"bourse > débourser"
"déboutonné"	"debutɔ̃ne"	"boutonner > déboutonner"
"débouyé"	"debuje"	"débrouiller"
"débouyé 2"	"debuje"	"débrouiller"
"débranché"	"debʀɑ̃ʃe"	"brancher > débrancher"
"débridé"	"debʀide"	"brider > débrider"
"débwaré"	"debwaʀe"	"bras"
"débwazé"	"debwaze"	"boiser > déboiser"
"débwété cf bwété"	"debwete"	"boiter"
"débwousayé"	"debwusaje"	"brousaille > débrousailler"
"déchajé"	"deʃaʒe"	"charger > décharger"
"déchalviré"	"deʃalviʀe"	"chavirer"
"déchayé"	"deʃaje"	"charrier"
"déchéné"	"deʃene"	"chaîne > déchaîner"
"déchèpiyé"	"deʃεpije"	"charpie"
"déchifonné"	"deʃifɔ̃ne"	"déchiffonner"
"déchiktayé"	"deʃiktaje"	"xxx"
"déchikté"	"deʃikte"	"déchiqueter"
"déchiré vr chiré"	"deʃiʀe"	"déchirer"
"déchosé"	"deʃose"	"déchausser"
"déchouké"	"deʃuke"	"xxx"
"dédi"	"dedi"	"dire > dédire"
"dédomajé"	"dedomaʒe"	"dédommager"
"dédoublé"	"deduble"	"dédoubler"
"dédui"	"dedɥi"	"dédommager"
"défaché"	"defaʃe"	"défâcher"
"défalké"	"defalke"	"défalquer"
"défann"	"defɑ̃n"	"défendre"
"défèt"	"defεt"	"faire >défaire"
"déféyé"	"defeje"	"défeuiller"
"défigiré"	"defigiʀe"	"figure > défigurer"
"défilé"	"defile"	"file > défiler"
"défofilé"	"defofile"	"faufiler > défaufiler"
"défonsé"	"defɔ̃se"	"défoncer"
"défòrmé"	"defɔʀme"	"déformer"
"défriché"	"defʀiʃe"	"défricher"
"défrizé"	"defʀize"	"friser > défriser"
"dégajé"	"degaʒe"	"dégager"
"dégaré"	"degaʀe"	"garer"
"dégarni"	"degaʀni"	"dégarnir"
"dégizé"	"degize"	"déguiser"
"dégochi"	"degoʃi"	"dégauchir"
"dégòjé"	"degɔʒe"	"dégorger"
"dégonflé"	"degɔ̃fle"	"gonfler > dégonfler"
"dégoudi"	"degudi"	"dégourdir"
"dégouté"	"degute"	"dégoutter"
"dégouté 2"	"degute"	"dégoûter"
"dégouté 3"	"degute"	"dégoûter"
"dégrafé"	"degʀafe"	"dégrafer"
"dégrapé"	"degʀape"	"dégrapper = égrapper"
"dégrengolé"	"degʀɛ̃gole"	"dégringoler"
"dégrenné"	"degʀɛ̃ne"	"xxx"
"dégrésé"	"degʀese"	"graisse"
"dégriji"	"degʀiʒi"	"xxx"
"déjanbé"	"deʒɑ̃be"	"jambe"
"déjiné"	"deʒine"	"déjeuner"
"déjivré"	"deʒivʀe"	"givrer > dégivrer"
"déjouké"	"deʒuke"	"joug"
"dékabosé"	"dekabose"	"cabosser > décabosser (LAR.."
"dékachté"	"dekaʃte"	"cacheter > décacheter"
"dékalboré"	"dekalboʀe"	"xxx"
"dékalé"	"dekale"	"xxx"
"dékalé 2"	"dekale"	"écale > écaler"
"dékalé 3"	"dekale"	"xxx"
"dékalfouké"	"dekalfuke"	"xxx"
"dékalké"	"dekalke"	"calquer >décalquer"
"dékanpé"	"dekɑ̃pe"	"camper > décamper"
"dékanté"	"dekɑ̃te"	"xxx"
"dékanté 2"	"dekɑ̃te"	"xxx"
"dékanté 3"	"dekɑ̃te"	"décanter"
"dékarkasé"	"dekaʀkase"	"carcasse > décarcasser"
"dékatyé"	"dekatje"	"quartier"
"dékazé"	"dekaze"	"case"
"déklaré"	"deklaʀe"	"déclarer"
"déklouwé"	"delkuwe"	"clouer > déclouer"
"dékochi"	"dekoʃi"	"xxx"
"dékòchté"	"dekɔʃte"	"crocheter"
"dékofré"	"dekofʀe"	"coffrer > décoffrer"
"dékolé"	"dekole"	"coller > décoller"
"dékolé 2"	"dekole"	"décoller"
"dékolé 3"	"dekole"	"décoller"
"dékonmandé"	"dekɔ̃mɑ̃de"	"commander > décommander"
"dékonséyé"	"dekɔ̃seje"	"conseiller > déconseiller"
"dékontrolé"	"dekɔ̃tʀole"	"contrôler"
"dékoré"	"dekoʀe"	"décorer"
"dékoré 2"	"dekoʀe"	"décorer"
"dékouché"	"dekuʃe"	"coucher > découcher"
"dékoud"	"dekud"	"coudre > découdre"
"dékoud 2"	"dekud"	"coudre > découdre"
"dékoupé"	"dekupe"	"couper >découper"
"dékoupé 2"	"dekupe"	"couper > découper"
"dékourajé"	"dekuʀaʒe"	"décourager"
"dékouvè"	"dékuvε"	"découvrir"
"dékòviyé"	"dekɔvije"	"xxx"
"dékrasé"	"dekʀase"	"crasse > décrasser"
"dékravaté"	"dekʀavate"	"cravater > décravater (LITTRE)"
"dékrété"	"dekʀete"	"décréter"
"dékwazé"	"dekwaze"	"croiser >décroiser"
"dékwenné"	"dekwɛ̃ne"	"couenne"
"dékwenné 2"	"dekwɛ̃ne"	"couenne"
"dékwensé"	"dekwɛ̃nse"	"coincer > décoincer"
"délaké"	"delake"	"xxx"
"délasi"	"delasi"	"délasser"
"délégé"	"delege"	"déléguer"
"déléyé"	"deleje"	"délayer"
"délibéré"	"delibeʀe"	"délibérer"
"délibéré 2"	"delibeʀe"	"délibérer"
"déligné"	"deliɲe"	"ligne"
"délimité"	"delimite"	"délimiter"
"délojé"	"deloʒe"	"déloger"
"délyanné"	"deljɑ̃ne"	"xxx"
"délyé"	"delje"	"délier"
"démaké"	"demake"	"marquer > démarquer"
"démanché"	"demɑ̃ʃe"	"démancher"
"démanjé"	"demɑ̃ʒe"	"démanger"
"démanti"	"demɑ̃ti"	"mentir > démentir"
"démantibilé"	"demɑ̃tibile"	"démantibuler"
"démantlé"	"demɑ̃tle"	"démanteler"
"démaré"	"demaʀe"	"demarrer"
"démasyé"	"demasje"	"démasquer"
"dématé"	"demate"	"démâter"
"démayé"	"demaje"	"xxx"
"démayoté"	"demajote"	"maillot > démaillotter"
"démélé"	"demele"	"démêler"
"déménajé"	"demenaʒe"	"déménager"
"démèrdé"	"demεʀde"	"merde > démerder"
"démérité"	"demeʀite"	"mériter > démériter"
"démèt"	"demεt"	"mettre > démettre"
"démisyonné"	"demisjɔ̃ne"	"démissionner"
"démobilizé"	"demobilize"	"mobiliser > démobiliser"
"démòd"	"demɔd"	"mordre > démordre"
"démonté"	"demɔ̃tʀe"	"monter > démonter"
"démontré"	"demɔ̃te"	"montrer > démontrer"
"démoralizé"	"demoʀalize"	"démoraliser"
"démoulé"	"demule"	"mouler > démouler"
"dénaté"	"denate"	"natter > dénatter"
"déniché"	"deniʃe"	"dénicher"
"dénigré"	"denigʀe"	"dénigrer"
"dénonsé"	"denɔ̃se"	"dénoncer"
"dépalé"	"depale"	"parler > déparler"
"dépalé 2"	"depale"	"parler > déparler"
"dépalé 3"	"depale"	"parler > déparler"
"dépann"	"depɑ̃n"	"pendre > dépendre"
"dépann 2"	"depɑ̃n"	"pendre > dépendre"
"dépann 3"	"depɑ̃n"	"pendre > dépendre"
"dépanné"	"depɑ̃né"	"panne > dépanner"
"dépansé"	"depɑ̃se"	"dépense > dépenser"
"départajé"	"depaʀtaʒe"	"partager"
"dépasé"	"depase"	"dépasser"
"dépaté"	"depate"	"xxx"
"dépayé"	"depaje"	"parier"
"dépayé 2"	"depaje"	"paille > dépailler"
"dépéché"	"depeʃe"	"dépêcher"
"dépengné"	"depɛ̃ɲe"	"peigner > dépeigner"
"dépéri"	"depeʀi"	"dépérir"
"dépéyizé"	"depejize"	"pays > dépayser"
"déplasé"	"deplase"	"placer > déplacer"
"déplimé cf plimé"	"deplime"	"plumer > déplumer"
"dépliyé"	"deplije"	"déplier"
"déplotonné"	"deplotɔ̃ne"	"dépelotonner"
"dépouyé"	"depuje"	"dépouiller"
"dépozé"	"depoze"	"déposer"
"dépri"	"depʀi"	"prendre"
"dépwélé"	"depwele"	"poil"
"dépyété"	"depjete"	"xxx"
"déraciné"	"deʀasine"	"déraciner"
"déranger 2"	"deʀɑ̃ʒe"	"déranger"
"déranjé"	"deʀɑ̃ʒe"	"ranger > déranger"
"déranpli"	"deʀɑ̃pli"	"remplir"
"dérapé"	"deʀape"	"déraper"
"dérasiné"	"deʀasine"	"racine > déraciner"
"dérayé"	"deʀaje"	"rail > dérailler"
"dérédi"	"deʀedi"	"déraidir"
"déréglé"	"deʀegle"	"régler > dérégler"
"dérèspèkté"	"deʀεspekte"	"respecter"
"dérèspèkté 2"	"deʀεspekte"	"respecter"
"dérifizé cf rèfizé"	"deʀifize"	"refuser"
"désalé"	"desale"	"saler > dessaler"
"désann"	"desɑ̃n"	"descendre"
"déséré"	"deseʀe"	"desserrer"
"désèvi"	"desεvi"	"servir > desservir"
"désèvwa"	"desεvwa"	"decevoir"
"désidé"	"deside"	"décider"
"désiné"	"desine"	"dessiner"
"désòti cf sòti"	"desɔti"	"sortir"
"désoulé"	"desule"	"soûler > dessoûler"
"détablé"	"detable"	"table"
"détaché"	"detaʃe"	"tache >détacher"
"détaché 2"	"detaʃe"	"détacher"
"détann"	"detɑ̃n"	"détendre"
"détann 2"	"detɑ̃n"	"tendre > détendre"
"détayé"	"detaje"	"tailler > détailler"
"détenn"	"detɛ̃n"	"déteindre"
"détéré"	"deteʀe"	"terre > deterrer"
"détiké"	"detike"	"tique"
"détiré"	"detiʀe"	"tirer > détirer"
"détlé"	"detle"	"dételer"
"détòd"	"detɔd"	"tordre > détordre"
"détòtiyé"	"detɔtije"	"détortiller"
"détranpé"	"detʀɑ̃pe"	"tremper > détremper"
"détronpé"	"detʀɔ̃pe"	"détromper"
"détui"	"detɥi"	"detruire"
"dévalé"	"devale"	"dévaler"
"dévalizé"	"devalize"	"dévaliser"
"dèvansé"	"dɛvɑ̃se"	"devancer"
"dévasté"	"dévaste"	"dévaster"
"dévidé"	"devide"	"vider > dévider"
"dèviné"	"dεvine"	"deviner"
"déviré"	"deviʀe"	"dévirer tourner en sens inverse)"
"dévisé"	"devise"	"visser > dévisser"
"dévoré"	"devoʀe"	"dévorer"
"dévwè"	"devwε"	"xxx"
"dévyé"	"devwe"	"dévier"
"déwoché"	"dewoʃe"	"xxx"
"déwoulé"	"dewule"	"dérouler"
"dézabityé"	"dezabitje"	"habituer > déshabituer"
"dézabiyé"	"dezabije"	"habiller > déshabiller"
"dézakòrdé"	"dezakɔʀde"	"accorder > désaccorder"
"dézanbaglé"	"dezɑ̃bagle"	"xxx"
"dézanbalé"	"dezɑ̃bale"	"emballer > désemballer"
"dézanbwaté"	"dezɑ̃bwate"	"désemboîter"
"dézanjanbé"	"dezɑ̃ʒɑ̃be"	"enjamber"
"dézankastré"	"dezɑ̃kastʀe"	"encastrer > désencastrer"
"dézankayé"	"dezɑ̃kaje"	"xxx"
"dézankonbré"	"dezɑ̃kɔ̃bʀe"	"encombrer > désencombrer"
"dézankrasé"	"dezɑ̃krase"	"désencrasser (emp par Gide)"
"dézanmélé"	"dezɑ̃mele"	"xxx"
"dézannuyé"	"dezɑ̃nɥije"	"ennuyer > désennuyer"
"dézanragé"	"dezɑ̃ʀaje"	"enrager"
"dézanrimé"	"dezɑ̃ʀime"	"desenrhumer"
"dézantòtiyé"	"dezɑ̃tɔtije"	"désentortiller"
"dézanwoulé"	"dezɑ̃wule"	"désenrouler"
"dézapiyé"	"dezapije"	"appuyer"
"dézaprann"	"dezapʀɑ̃n"	"apprendre > désapprendre"
"dézavantajé"	"dezavɑ̃taʒe"	"avantager > désavantager"
"dézenfekté"	"dezɛ̃fekte"	"infecter > désinfecter"
"dézèrbé"	"dezɛ̃ʀbe"	"herbe > désherber"
"dézisté"	"deziste"	"désister"
"dézobéyi"	"dezobeji"	"obéir > désobéir"
"dézongé"	"dezɔ̃ge"	"xxx"
"dézonoré"	"dezonoʀe"	"honorer > déshonorer"
"dézosé"	"dezose"	"os > désosser"
"di"	"di"	"dire"
"diféransyé"	"difeʀɑ̃sje"	"différencier"
"dijéré"	"diʒeʀe"	"digérer"
"dilapidé"	"dilapide"	"dilapider"
"diminyé"	"diminje"	"diminuer"
"diné"	"dine"	"dîner"
"diré"	"diʀe"	"durer"
"direksyonné"	"diʀεksjɔ̃ne"	"direction"
"diskité"	"diskite"	"discuter"
"diskoupé"	"diskupe"	"xxx"
"disparèt"	"dispaʀεt"	"disparaître"
"dispozé"	"dispoze"	"disposer"
"dispozé 2"	"dispoze"	"disposer"
"distilé"	"distile"	"distiller"
"distribiyé"	"distʀibije"	"distribuer"
"diviné"	"divine"	"deviner"
"divini"	"divini"	"devenir"
"divizé"	"divize"	"diviser"
"divòsé"	"divɔse"	"divorce > divorcer"
"djobé"	"dʒobe"	"xxx"
"dòmi"	"dɔmi"	"dormir"
"donté"	"dɔ̃te"	"dompter"
"dòrloté"	"dɔʀlote"	"dorloter"
"doublé"	"duble"	"doubler"
"doublé 2 var rèdoublé"	"duble"	"doubler"
"douché"	"duʃe"	"douche > doucher"
"dousi"	"dusi"	"doux > adoucir"
"dousiné"	"dusine"	"xxx"
"douté"	"dute"	"douter"
"douwé"	"duwe"	"xxx"
"dozé"	"doze"	"dose > doser"
"dramatizé"	"dʀamatize"	"drame > dramatiser"
"drésé"	"dʀese"	"dresser"
"drésé 2"	"dʀese"	"dresser"
"drésé 3"	"dʀese"	"dresser"
"drivayé"	"dʀivaje"	"xxx"
"drivé"	"dʀive"	"ang drive"
"drogé"	"dʀoge"	"drogue > droguer"
"dwété"	"dwete"	"xxx"
"dyézé"	"djeze"	"dièse"
"èché cf chèché"	"εʃe"	"chercher"
"échwé"	"eʃwe"	"échouer"
"échwé 2"	"eʃwe"	"échouer"
"édiké"	"edike"	"éduquer"
"éfarouché"	"efaruʃe"	"farouche > effaroucher"
"éfasé"	"efase"	"effacer"
"égalizé"	"egalize"	"égal > égaliser"
"égalizé 2"	"egalize"	"égal > égaliser"
"égouté"	"eguté"	"goutte > égoutter"
"égri 2"	"egʀi"	"aigre > aigrir"
"ègzajéré"	"εgzaʒeʀe"	"exagérer"
"ègzaminé"	"εgzamine"	"examen > examiner"
"ékéré"	"ekeʀe"	"équerre > équerrer"
"ékimé"	"ekime"	"écume > écumer"
"éklò"	"eklɔ"	"éclore"
"ékonomizé"	"ekonomize"	"économie >économiser"
"ékri"	"ekʀi"	"écrire"
"èksité"	"εksite"	"exciter"
"èkzilé"	"εkzile"	"exiler"
"èkzisté"	"εkziste"	"exister"
"élèvé var élivé"	"elεve"	"élever"
"élèvé var élivé 2"	"elεve"	"élever"
"éli"	"eli"	"élire"
"élivé cf élèvé"	"elive"	"élever"
"élivé cf élèvé 2"	"elive"	"élever"
"endamnizé"	"ɛ̃dɑ̃mnize"	"indemniser"
"énèrvé"	"enεʀve"	"énerver"
"enfèkté"	"ɛ̃fεkte"	"infecter"
"enfekté 2"	"ɛ̃fεkte"	"infecter"
"enfizé"	"ɛ̃fize"	"infuser"
"enfòrmé"	"ɛ̃fɔʀme"	"informer"
"enkomodé"	"ɛ̃komode"	"incommoder"
"enkyété"	"ɛ̃kjete"	"inquiéter"
"enmé"	"ɛ̃me"	"aimer"
"enploré"	"ɛ̃ploʀe"	"implorer"
"enpozé"	"ɛ̃poze"	"imposer"
"enprovizé"	"ɛ̃pʀovize"	"improviser"
"ensinéré"	"ɛ̃sineʀe"	"incinérer"
"ensisté"	"ɛ̃siste"	"insister"
"enskri"	"ɛ̃skʀi"	"inscrire"
"enspèkté"	"ɛ̃spεkte"	"inspecter"
"enstalé"	"ɛ̃stale"	"installer"
"entèrdi"	"ɛ̃tεʀdi"	"interdire"
"entéré"	"ɑ̃teʀe"	"terre > enterrer"
"entérésé"	"ɛ̃teʀese"	"intérêt > intéresser"
"entérojé"	"ɛ̃teʀoʒε"	"interroger"
"entimidé"	"ɛ̃timide"	"intimider"
"entrigé"	"ɛ̃tʀige"	"intriguer"
"envanté"	"ɛ̃vɑ̃te"	"inventer"
"envité"	"ɛ̃vite"	"inviter"
"envoké"	"ɛ̃voke"	"invoquer"
"éparpiyé"	"epaʀpije"	"éparpiller"
"épési"	"epesi"	"épais > épaissir"
"éplé"	"eple"	"épeler"
"épousté"	"epuste"	"épousseter"
"éraflé"	"eʀafle"	"érafler"
"érityé"	"eʀitje"	"hériter"
"éséyé"	"eseje"	"essayer"
"èskenté"	"εskɛ̃te"	"esquinter"
"èskizé"	"εskize"	"excuser > excuse"
"èskomigné"	"εskomiɲe"	"excommunier"
"ésoré"	"esoʀe"	"essorer"
"èspasé"	"εspase"	"espace > espacer"
"èspédyé"	"εspedje"	"expédier"
"èspéré"	"εspeʀe"	"espérer"
"èspliké"	"εsplike"	"expliquer"
"èspozé"	"εkspoze"	"exposer"
"èspozé 2"	"εspoze"	"exposer"
"èspwaté"	"εspwate"	"exploiter"
"èstimé"	"εstime"	"estimer"
"èstimé 2"	"εstime"	"estimer"
"èstropyé"	"εstʀopje"	"estropier"
"étalé"	"etale"	"étaler"
"étann"	"etɑ̃n"	"étendre"
"étenn"	"etɛ̃n"	"éteindre"
"étèrniyé"	"etεʀnije"	"éternuer"
"éternizé"	"etεʀnize"	"éterniser"
"étidyé"	"etidje"	"étudier"
"étivé"	"etive"	"étuve > étuver"
"étoné"	"etone"	"étonner"
"évaporé"	"evapoʀe"	"évaporer"
"ézité"	"ezite"	"hésiter"
"faché 2"	"faʃe"	"fâcher"
"faké"	"fake"	"xxx"
"falsifyé"	"falsifyé"	"falsifier"
"fann"	"fɑ̃n"	"fendre"
"fann 2"	"fɑ̃n"	"fendre"
"fann kann"	"fɑ̃nkɑ̃n"	"fendre"
"fardé"	"faʀde"	"farder > fard"
"fasadé"	"fasade"	"face"
"fasilité"	"fasilite"	"faciliter"
"favorizé"	"favoʀize"	"favoriser"
"fawouché"	"fawuʃe"	"effaroucher"
"fè"	"fε"	"faire"
"fè bas"	"fεbas"	"faire-basse"
"fè dèyè"	"fεdεjε"	"faire"
"fè fon"	"fεfɔ̃"	"faire"
"fè jé"	"fεʒe"	"faire-jeu"
"fè jès"	"fεʒεs"	"faire"
"fè kò"	"fεkɔ"	"faire"
"fè kokangn"	"fεkokɑ̃ɲ"	"faire"
"fè konplo"	"fεkɔ̃plo"	"complot"
"fè kouyon"	"fεkujɔ̃"	"faire"
"fè lafraz"	"fεlafʀaz"	"faire"
"fè lèd"	"fεlεd"	"faire"
"fè mannèv"	"fεmɑ̃nεv"	"faire"
"fè pach"	"fεpaʃ"	"faire"
"fè vis"	"fεvis"	"faire-vice"
"fè zanmi"	"fεzɑ̃mi"	"faire-amie"
"fébli"	"febli"	"faiblir"
"fékondé"	"fekɔ̃de"	"féconder"
"félisité"	"felisite"	"féliciter"
"fèmé"	"fεme"	"fermer"
"fen 2"	"fɛ̃"	"faim"
"fengnantizé"	"fɛ̃ɲɑ̃tize"	"fainéant > fainéanter"
"fenté"	"fɛ̃te"	"feinte > feinter"
"férayé"	"feʀaje"	"ferrailler"
"féré"	"feʀe"	"fer"
"féré 2"	"feʀe"	"fer > ferrer"
"fésé"	"fese"	"xxx"
"fèt"	"fεt"	"faire"
"fèt 2"	"fεt"	"faire"
"fété"	"fete"	"fête > fêter"
"fèyté"	"fεjte"	"feuille > feuilleter"
"fifiné"	"fifine"	"xxx"
"figiré"	"figiʀe"	"figurer"
"fiksé"	"fikse"	"fixer"
"fiktosé"	"fiktose"	"fly-tox"
"filé"	"file"	"fil > affiler"
"filmé"	"filme"	"filmer"
"filté"	"filte"	"fileter"
"filtré"	"filtʀe"	"filtrer"
"fimé"	"fime"	"fumer"
"fin"	"fin"	"finir"
"fini"	"fini"	"finir"
"flangé"	"flɑ̃ge"	"xxx"
"flaté"	"flate"	"flatter"
"fléché"	"flεʃe"	"flèche"
"flèks"	"flεks"	"xxx"
"fléré"	"fleʀe"	"flairer"
"fléri"	"fleʀi"	"fleur > fleurir"
"flijé"	"fliʒe"	"figer"
"flipé"	"flipe"	"flipper"
"floté"	"flote"	"flotter"
"fofilé"	"fofile"	"faufiler"
"fofilé 2"	"fofile"	"faufiler"
"fonksyonné"	"fɔ̃ktjɔ̃ne"	"fonction > fonctionner"
"fonn"	"fɔ̃n"	"fondre"
"fonsé 1"	"fɔ̃se"	"froncer"
"fòrjé"	"fɔʀʒe"	"forger"
"fòrtifyé"	"fɔʀtifje"	"fortifier"
"fòsé"	"fɔse"	"forcer"
"fotografyé"	"fotogʀafje"	"photographier"
"fotokopyé"	"fotokopje"	"photocopie >photocopier"
"fou 2 var fouté"	"fu"	"foutre"
"fouchté"	"fuʃte"	"fourche >  fourcheter"
"foukan"	"fukɑ̃"	"foutre"
"foulé"	"fule"	"fouler"
"foulé 2"	"fule"	"fouler"
"foulé 3"	"fule"	"fouler"
"foumwalkan"	"fumwalkɑ̃"	"foutre-camp"
"fouré"	"fuʀe"	"fourrer"
"fouté cf fou"	"fute"	"foutre"
"foutélikan cf foukan"	"futelikɑ̃"	"foutre"
"foutémwalkan"	"futemwalkɑ̃"	"foutre"
"fouti"	"futi"	"xxx"
"fouyé"	"fuje"	"fouiller"
"fraksé"	"fʀakse"	"xxx"
"frapé 2"	"fʀape"	"frapper"
"frazé"	"fʀaze"	"phrase"
"frékanté"	"fʀekɑ̃te"	"fréquenter"
"frenné"	"fʀɛ̃ne"	"freiner"
"fri"	"fʀi"	"frire"
"friksyonné"	"fʀiksjɔ̃ne"	"friction > frictionner"
"frimé"	"fʀime"	"frimer"
"frisonné"	"fʀisɔ̃ne"	"frisson > frissonner"
"froté"	"fʀote"	"frotter"
"froté 2"	"fʀote"	"frotter"
"fui"	"fɥi"	"fuir"
"fwèt 1"	"fwεt"	"froid"
"fwiné"	"fwine"	"fouiner"
"fyé"	"fje"	"fier"
"gaché"	"gaʃe"	"gâcher"
"gadé"	"gade"	"regarder"
"gadé 2"	"gade"	"regarder"
"gadé 3"	"gade"	"garder"
"gadé-vwè"	"gadevwε"	"regarder-voir"
"galopé"	"galope"	"galop > galoper"
"gangné"	"gɑ̃ɲe"	"gagner"
"gangné 2"	"gɑ̃ɲe"	"gagner"
"ganmé"	"gɑ̃me"	"gamme"
"ganté"	"gɑ̃te"	"gant > ganter"
"garé"	"gaʀe"	"garer > gare"
"garni"	"gaʀni"	"garnir"
"gaspiyé"	"gaspije"	"gaspiller"
"gaté"	"gate"	"gâter"
"gavé"	"gave"	"gaver"
"gay"	"gaj"	"xxx"
"gazouyé"	"gazuje"	"gazouiller"
"gélé"	"gele"	"gueuler"
"géri"	"geʀi"	"guérir"
"gété"	"gete"	"guetter"
"gidonné"	"gidɔ̃ne"	"guidon"
"giflé"	"ʒifle"	"xxx"
"glingsé"	"gliɲse"	"glisser"
"glorifyé"	"gloʀifje"	"glorifier"
"gnanké"	"ɲɑ̃ke"	"xxx"
"gobé"	"gobe"	"gober"
"gòjété"	"gɔʒete"	"gorge"
"gomé"	"gome"	"gomme > gommer"
"gonflé"	"gɔ̃fle"	"gonfler"
"gonflé 2"	"gɔ̃fle"	"gonfler"
"goudronné"	"gudʀɔ̃ne"	"goudronner"
"goumé"	"gume"	"gourmer"
"gouté"	"gute"	"goûter"
"gouvèné"	"guvεne"	"gouverner"
"gouyé"	"guje"	"grouiller"
"grafigné"	"gʀafiɲe"	"grafigner"
"grajé"	"gʀaʒe"	"xxx"
"grandi"	"gʀɑ̃di"	"grandir"
"grasyé"	"gʀasje"	"gracier"
"graté"	"gʀate"	"gratter"
"gravé"	"gʀave"	"graver"
"gréfé"	"gʀefe"	"greffe > greffer"
"grèloté"	"gʀεlote"	"grelotter"
"grenné"	"gʀɛ̃ne"	"égrener"
"grenpé"	"gʀɛ̃pe"	"grimper"
"grensé"	"gʀɛ̃se"	"grincer"
"grésé"	"gʀese"	"graisser"
"gréziyé"	"gʀezije"	"grésiller"
"grifé"	"gʀife"	"griffe > griffer"
"grifé 2"	"gʀife"	"griffe > griffer"
"grifé 3"	"gʀife"	"griffer > griffer"
"grigné"	"gʀiɲe"	"grigner"
"griji"	"gʀiʒi"	"xxx"
"griji 2"	"gʀiʒi"	"xxx a rapprocher de grajé"
"griyé"	"gʀije"	"griller"
"grosi"	"gʀosi"	"grossir"
"gwenfré"	"gwɛ̃fʀe"	"goinfre > goinfrer"
"haché"	"haʃe"	"hacher"
"haché 2"	"haʃe"	"hacher"
"hanni"	"hɑ̃ni"	"hennir"
"hélé"	"hele"	"héler"
"hisé"	"hise"	"hisser"
"hosé"	"hose"	"hausser"
"iliminé"	"ilimine"	"illuminer"
"imajiné"	"imaʒine"	"imaginer"
"imité"	"imite"	"imiter"
"inogiré"	"inogiʀe"	"inaugurer"
"inondé"	"inɔ̃de"	"inondé"
"inòptizé"	"inɔptize"	"hypnotiser"
"itilizé"	"itilize"	"utiliser"
"izé"	"ize"	"user"
"izolé"	"izolé"	"isoler"
"janbé"	"ʒɑ̃be"	"jambe > enjamber"
"japé"	"ʒape"	"japper"
"jenné"	"ʒɛ̃ne"	"gêner"
"jéré"	"ʒeʀe"	"gérer"
"jété"	"ʒete"	"jeter"
"jété 2"	"ʒete"	"jeter"
"jijé"	"ʒiʒe"	"juger"
"jiré"	"ʒiʀe"	"jurer"
"jistifyé"	"ʒistifje"	"justifier"
"jivré 2"	"ʒivʀe"	"givrer"
"jojé"	"ʒoʒe"	"jauger"
"joni"	"ʒoni"	"jaunir"
"jouké"	"ʒuke"	"joug"
"jouké 2 var  jiké"	"ʒuke"	"jucher"
"jouwé"	"ʒuwe"	"jouer"
"jwenn"	"ʒwɛ̃n"	"joindre"
"jwenn 2"	"ʒwɛ̃n"	"joindre"
"jwi"	"ʒɥi"	"jouir"
"jwi 2"	"ʒɥi"	"jouir"
"kabanné"	"kabɑ̃ne"	"cabane"
"kabanné 2"	"kabɑ̃ne"	"cabane"
"kabosé"	"kabose"	"cabosser"
"kaché"	"kaʃe"	"cacher"
"kachté"	"kaʃte"	"cacheter"
"kajolé"	"kaʒole"	"cajoler"
"kaka"	"kaka"	"caca"
"kalanjé"	"kalɑ̃ʒe"	"xxx"
"kalbanné"	"kalbɑ̃ne"	"xxx"
"kalé"	"kale"	"xxx"
"kalé 2"	"kale"	"caler"
"kalkilé"	"kalkile"	"calculer > calcul"
"kalkilé 2"	"kalkile"	"calculer > calcul"
"kalmé"	"kalme"	"calmer"
"kalpaté"	"kalpaté"	"xxx"
"kanbré"	"kɑ̃bʀe"	"cambrer"
"kanni"	"kãni"	"canir"
"kanpé"	"kɑ̃pe"	"camper"
"kanté"	"kãte"	"cant (reg normand)"
"kapoté"	"kapote"	"capoter"
"kapté"	"kapte"	"capter"
"karanbolé"	"kaʀɑ̃bole"	"caramboler"
"kardé"	"kaʀde"	"carder"
"karé 3"	"kaʀe"	"carrer"
"karésé"	"kaʀese"	"caresser"
"kariyonné"	"kaʀijɔ̃ne"	"carillonner"
"karlé"	"kaʀle"	"carreler"
"kasé"	"kase"	"casser"
"kaskòd"	"kaskɔd"	"casser-corde"
"kaskouté"	"kaskute"	"casse-croûte"
"kastré"	"kastʀe"	"castrer"
"kay"	"kaj"	"aller"
"kayé"	"kaje"	"écaille > écailler"
"kayé 2"	"kaje"	"cailler"
"kayé 4"	"kaje"	"xxx"
"kémandé"	"kemɑ̃de"	"quémander"
"kenbé"	"kɛ̃be"	"tenir"
"kenn"	"kɛ̃n"	"xxx"
"kèsyonné"	"kεksjɔ̃ne"	"question > questionner"
"kilé"	"kile"	"reculer"
"kimé"	"kime"	"écumer"
"kimé 2"	"kime"	"écumer"
"kipé"	"kipe"	"xxx"
"kiré"	"kiʀe"	"curer"
"kité"	"kite"	"quitter"
"klaké"	"klake"	"claquer"
"klasé"	"klase"	"classer"
"kléré"	"kleʀe"	"éclairer"
"kléré 2"	"kleʀe"	"éclairer"
"kléronné"	"kleʀɔ̃ne"	"clairon >claironner"
"klèsi"	"klεsi"	"éclaicir"
"klignoté"	"kliɲote"	"clignoter"
"klimatizé"	"klimatize"	"climatiser"
"kloché"	"kloʃe"	"clocher"
"klouwé"	"kluwe"	"clou > clouer"
"koagilé"	"koagile"	"coaguler"
"kòché"	"kɔʃe"	"écorcher"
"kòché 2"	"kɔʃe"	"écorcher"
"kòché 3"	"kɔʃe"	"écorcher"
"kòchté"	"kɔʃte"	"crochet > crocheter"
"kòchté 2"	"kɔʃte"	"xxx"
"kofré"	"kofʀe"	"coffre >coffrer"
"koké"	"koke"	"xxx"
"kokiné"	"kokine"	"coquiner vieux)"
"kolanké"	"kolɑ̃ke"	"xxx"
"kolasyonné"	"kolasjɔ̃ne"	"collationner"
"kolé"	"kole"	"coller"
"kolèksyonné"	"kolεktjɔ̃ne"	"collection > collectionner"
"kolonizé"	"kolonize"	"colonie > coloniser"
"koloryé"	"koloʀje"	"colorier"
"kòlpòté"	"kɔlpɔte"	"colporter"
"kòlté"	"kɔlte"	"col"
"konbat"	"kɔ̃bat"	"combattre"
"konbiné"	"kɔ̃bine"	"combiner"
"konblé"	"kɔ̃ble"	"combler"
"kondanné"	"kɔ̃dɑ̃ne"	"condamner"
"kondanné 2"	"kɔ̃dɑ̃ne"	"condamner"
"kondisyonné"	"kɔ̃disjɔ̃ne"	"conditionner"
"kondui"	"kɔ̃dɥi"	"conduire"
"kòné"	"kɔne"	"corne"
"konfésé"	"kɔ̃fese"	"confesser"
"konfirmé"	"kɔ̃fiʀme"	"confirmer"
"konfiské"	"kɔ̃fiske"	"confisquer"
"konfonn"	"kɔ̃fɔ̃n"	"confondre"
"konfyé"	"kɔ̃fje"	"confier"
"kongné"	"kɔ̃ɲe"	"cogner"
"kongné 2"	"kɔ̃ɲe"	"cogner"
"kòniflé"	"kɔnifle"	"xxx"
"konjèlé"	"kɔ̃ʒεle"	"congeler"
"konjigé"	"kɔ̃ʒige"	"conjuguer"
"konkasé"	"kɔ̃kase"	"concasser"
"konkòrdé"	"kɔ̃kɔʀde"	"concorder"
"konkouri"	"kɔ̃kuʀi"	"concourir"
"konmandé"	"kɔ̃mɑ̃de"	"commander"
"konmandé 2"	"kɔ̃mɑ̃de"	"commander"
"konmansé"	"kɔ̃mɑ̃se"	"commencer"
"konmigné"	"kɔ̃miɲe"	"communier"
"konnèt"	"kɔ̃nεt"	"connaître"
"konparé"	"kɔ̃paʀe"	"comparer"
"konplété"	"kɔ̃plete"	"complet  >compléter"
"konpliké 2"	"kɔ̃plike"	"compliquer"
"konploté"	"kɔ̃plote"	"comploter"
"konpòrté"	"kɔ̃pɔʀte"	"comporter"
"konpozé"	"kɔ̃poze"	"composer"
"konprann"	"kɔ̃pʀɑ̃n"	"comprendre"
"konpranndèdi"	"kɔ̃pʀɑ̃ndεdi"	"comprendre-dire"
"konpranndi"	"kɔ̃pʀɑ̃ndi"	"comprendre-dire"
"konsèrné"	"kɔ̃sεʀne"	"concerner"
"konséyé 1"	"kɔ̃seje"	"conseiller"
"konsidéré"	"kɔ̃sideʀe"	"considérer"
"konsigné"	"kɔ̃siɲe"	"consigner"
"konsilté"	"kɔ̃silte"	"consulter"
"konsolé"	"kɔ̃sole"	"consoler"
"konsolidé"	"kɔ̃solide"	"consolider"
"konsomé 2"	"kɔ̃some"	"consommer"
"konstaté"	"kɔ̃state"	"constater"
"konstipé"	"kɔ̃stipe"	"constiper"
"konstwi"	"kɔ̃stwi"	"construire"
"kontaminé"	"kɔ̃tamine"	"contaminer"
"kontanplé"	"kɔ̃tɑ̃ple"	"contempler"
"kontanté"	"kɔ̃tɑ̃te"	"content > contenter"
"kontanté 2"	"kɔ̃tɑ̃te"	"contenter"
"konté"	"kɔ̃te"	"compter"
"konté 2"	"kɔ̃te"	"compter"
"konté 3"	"kɔ̃te"	"compter"
"konté rézon"	"kɔ̃teʀezɔ̃"	"raisons (avoir des) picard"
"kontèsté"	"kɔ̃tεste"	"contester"
"kontinyé"	"kɔ̃tinje"	"continuer"
"kontraryé"	"kɔ̃tʀaʀje"	"contrarier"
"kontré cf rankontré"	"kɔ̃tʀe"	"rencontrer"
"kontrèdi"	"kɔ̃tʀεdi"	"contredire"
"kontrolé"	"kɔ̃tʀole"	"contrôle > contrôler"
"konvoké"	"kɔ̃voke"	"convoquer"
"kopyé"	"kopje"	"copier"
"koré"	"koʀe"	"accore>accorer = étayer"
"korèsponn"	"koʀεspɔ̃n"	"correspondre"
"korijé"	"koʀiʒe"	"corriger"
"kòsté  cf akòsté"	"kɔste"	"accoster"
"kotizé"	"kotize"	"cotiser"
"kouché"	"kuʃe"	"coucher"
"koud"	"kud"	"coudre"
"koulé"	"kule"	"couler"
"koulé 2"	"kule"	"couler (ex couler le thé)"
"koulisé"	"kulise"	"coulisser"
"koupé"	"kupe"	"couper"
"koupé 2 cf dékoupé"	"kupe"	"couper"
"koupé 3"	"kupe"	"couper"
"kouri"	"kuʀi"	"courir"
"kouri-alé"	"kuʀiale"	"courir-aller"
"kouri-désann"	"kuʀidesɑ̃n"	"courir-descendre"
"kouri-di"	"kuʀidi"	"courir-dire"
"kouri-kaché"	"kuʀikaʃe"	"courir-cacher"
"kouri-monté"	"kuʀimɔ̃te"	"courir-monter"
"kouri-vini"	"kuʀivini"	"courir-venir"
"kouronné"	"kuʀone"	"couronne > couronner"
"kouté"	"kute"	"écouter"
"kouté 2"	"kute"	"écouter"
"kouté 3"	"kute"	"coûter"
"koutlasé"	"kutlase"	"coutelas"
"kouvé"	"kuve"	"couver"
"kouvè"	"kuvε"	"couvrir"
"kouyonné"	"kujɔ̃ne"	"couillon > couillonner"
"kòviyé"	"kɔvije"	"xxx"
"kowonpi"	"kowɔ̃pi"	"corrompre"
"kozé"	"koze"	"cause >causer"
"kozé 3"	"koze"	"causer"
"kraché"	"kʀaʃe"	"cracher"
"kraké"	"kʀake"	"xxx"
"kraké 2"	"kʀake"	"craquer"
"kranponné"	"kʀɑ̃pɔ̃ne"	"cramponner"
"kravaté"	"kʀavate"	"cravate > cravater"
"krazé"	"kʀaze"	"écraser"
"krenn"	"kʀɛ̃n"	"craindre"
"krépiné"	"kʀepine"	"crépir"
"krévé"	"kʀeve"	"crever"
"krévé 2"	"kʀeve"	"crever"
"kriblé"	"kʀible"	"cribler"
"krispé"	"kʀispe"	"crisper"
"kristalizé"	"kʀistalize"	"cristalliser"
"kritiké"	"kʀitike"	"critique > critiquer"
"kritinizé"	"kʀitinize"	"xxx"
"kriyé"	"kʀije"	"crier > cri"
"kriyé 2"	"kʀije"	"crier > cri"
"krizé"	"kʀize"	"crise"
"kuit"	"kɥit"	"cuire"
"kwafé"	"kwafe"	"coiffer"
"kwaté"	"kwate"	"croix"
"kwazé"	"kwaze"	"croix > croiser"
"kwazé 2"	"kwaze"	"croix > croiser"
"kwazonné"	"kwazɔ̃ne"	"cloison > cloisonner"
"kwè"	"kwε"	"croire"
"kwensé"	"kwɛ̃se"	"coincer"
"kyansé cf tchansé"	"kjɑ̃se"	"xxx"
"kyoké"	"kjoke"	"xxx"
"kyoulé cf rèkilé"	"kjule"	"reculer"
"kyouwé"	"kjuwe"	"tuer"
"kyouyi"	"kjuji"	"cueillir"
"labouré"	"labuʀe"	"labourer"
"laché"	"laʃe"	"lacher"
"lagé"	"lage"	"larguer"
"laji"	"laʒi"	"large > élargir"
"laké"	"lake"	"xxx"
"lanbiné"	"lɑ̃bine"	"lambin > lambiner"
"lang 3"	"lɑ̃g"	"langue"
"langé"	"lɑ̃ge"	"xxx"
"lanké"	"lɑ̃ke"	"ancrer"
"lansé"	"lɑ̃se"	"lancer"
"lapidé"	"lapide"	"lapider"
"lasé"	"lase"	"lacer"
"lasi"	"lasi"	"las"
"lavandé"	"lavɑ̃de"	"lavande"
"lavé"	"lave"	"laver"
"lélé"	"lele"	"xxx"
"lésé"	"lese"	"laisser"
"lésivé"	"lesive"	"lessiver"
"lètché"	"lεtʃe"	"xxx"
"lévé"	"leve"	"lever"
"lévé 2"	"leve"	"lever"
"lévé 3"	"leve"	"lever"
"lévé cho"	"leveʃo"	"lever-chaud"
"lévé konvèsyon"	"levekɔ̃vɛsjɔ̃"	"xxx"
"li"	"li"	"lire"
"libéré"	"libeʀe"	"libérer"
"ligé"	"lige"	"liguer"
"likidé"	"likide"	"liquider"
"limé 2"	"lime"	"allumer"
"limer"	"lime"	"limer"
"liminé cf iliminé"	"limine"	"illuminer"
"lisansyé"	"lisɑ̃sje"	"licencier"
"lité"	"lite"	"lutter > lutte"
"livré"	"livʀe"	"livrer"
"lobé"	"lobe"	"lober"
"loché"	"loʃe"	"locher(fer à cheval prêt à tɔ̃bé)"
"lojé"	"loʒe"	"loger"
"lolé"	"lole"	"xxx"
"longviyé var lonviyé"	"lɔ̃gvije"	"xxx"
"lonjé"	"lɔ̃ʒe"	"long > longer"
"lonji"	"lɔ̃ʒi"	"long"
"lonji 2"	"lɔ̃ʒi"	"long"
"lòrgné"	"lɔʀɲe"	"lorgner"
"losyonné"	"losjɔ̃ne"	"lotionner"
"louché"	"luʃ"	"loucher"
"loudi"	"ludi"	"alourdir"
"louké"	"luke"	"louquer"
"loupé"	"lupe"	"louper"
"loupé 2"	"lupe"	"xxx"
"louwé"	"luwe"	"louer"
"luilé"	"lɥile"	"huiler"
"lyanné"	"ljɑ̃ne"	"liane"
"lyanné 2"	"ljɑ̃ne"	"liane"
"machandé"	"maʃɑ̃de"	"marchander"
"machandé 2"	"maʃɑ̃de"	"marchander"
"maché"	"maʃe"	"mâcher"
"maché 2"	"maʃe"	"marcher"
"maché kochi"	"maʃekoʃi"	"marcher"
"madragé"	"madʀage"	"xxx"
"makayé"	"makaje"	"xxx"
"maké"	"make"	"marque  > marquer"
"maké 2"	"make"	"marquer > marque"
"makiyé"	"makije"	"maquiller"
"makoté"	"makote"	"xxx"
"makrélé"	"makʀele"	"xxx"
"malaksé"	"malakse"	"malaxer"
"malmenné"	"malmɛ̃ne"	"malmener"
"malpalé"	"malpale"	"xxx"
"malpwòpté"	"malpwɔpte"	"malpropreté"
"maltrété"	"maltʀete"	"maltraiter"
"manché"	"mɑ̃ʃe"	"manche > emmancher"
"mandaté"	"mɑ̃date"	"mandater"
"mandé"	"mɑ̃de"	"demander"
"mandyanné"	"mɑ̃djɑ̃ne"	"mendier"
"manganné"	"mɑ̃gɑ̃ne"	"xxx"
"manifèsté"	"manifɛste"	"manifester"
"manjé"	"mɑ̃ʒe"	"manger"
"manjé 3"	"mɑ̃ʒe"	"manger"
"manjé bèk"	"mɑ̃ʒebɛk"	"manger"
"manké"	"mɑ̃ke"	"manquer"
"manké 2"	"mɑ̃ke"	"manquer"
"mannévré"	"mãnevʀe"	"manœuvrer"
"mannigansé"	"mɑ̃nigɑ̃se"	"manigancer"
"mannyé"	"mɑ̃nje"	"manier"
"mansyonné"	"mɑ̃sjɔ̃ne"	"mentionner"
"manti"	"mɑ̃ti"	"mentir"
"maré"	"maʀe"	"amarrer"
"margoté"	"maʀgote"	"marcotter"
"mariné"	"maʀine"	"mariner"
"mariné 2"	"maʀine"	"mariner"
"marmonné"	"maʀmɑ̃ne"	"marmonner"
"martirizé"	"maʀtirize"	"martyr > martyriser"
"masakré"	"masakre"	"massacrer"
"masé"	"mase"	"masser"
"masé 2"	"mase"	"masser"
"maséré"	"masere"	"macérer"
"maské cf masyé"	"masje"	"masquer"
"maskoté"	"maskote"	"xxx"
"mastiké"	"mastike"	"mastiquer"
"masyé"	"masje"	"masque > masquer"
"matché"	"matʃe"	"match >  matcher"
"maté"	"mate"	"mater"
"maté 2"	"mate"	"mater"
"mawon 2"	"mawɔ̃"	"marronner"
"mawonné"	"mawɔ̃ne"	"marronner"
"mayé"	"maje"	"marier"
"méblé"	"meble"	"meubler"
"méfyé"	"mefje"	"méfier"
"mégri"	"megʀi"	"maigre > maigrir"
"mélanjé"	"melɑ̃ʒe"	"mélange > mélanger"
"mèlba"	"mεlba"	"mettre-bas"
"mélé"	"mele"	"mêler"
"mélé 2"	"mele"	"mêler"
"mélé 3"	"mele"	"mêler"
"mélé 4"	"mele"	"mêler"
"ménajé"	"menaʒe"	"ménager"
"mènasé"	"mεnase"	"menace"
"menné"	"mɛ̃ne"	"mener"
"menné alé"	"mɛ̃neale"	"mener-aller"
"mensi"	"mɛ̃si"	"mince > mincir"
"méprizé"	"mepʀize"	"mépriser"
"mérité"	"meʀite"	"mérite > mériter"
"mèt"	"mεt"	"mettre"
"mèt atè"	"mεtatε"	"mettre"
"mété"	"mete"	"mettre"
"mètri"	"mεtʀi"	"meurtrir"
"mèwè"	"mεwε"	"xxx"
"miganné"	"migɑ̃ne"	"xxx"
"mijoté"	"miʒote"	"mijoter"
"miltipliyé"	"miltiplije"	"multiplier"
"miré"	"miʀe"	"mirer"
"mité"	"mite"	"muter"
"mizé"	"mize"	"miser"
"mizé 2"	"mize"	"miser"
"miziré"	"miziʀe"	"mesurer"
"mò"	"mɔ"	"mourir"
"mobilizé"	"mobilize"	"mobiliser"
"mòdé"	"mɔde"	"mordre"
"modéré"	"modeʀe"	"modérer"
"modi"	"modi"	"maudire"
"modifyé"	"modifje"	"modifier"
"moké"	"moke"	"moquer"
"moli"	"moli"	"mollir(donner du mou au cordage)"
"monopolizé"	"monopolize"	"monopoliser"
"monté"	"mɔ̃te"	"monter"
"monté konplo"	"mɔ̃tekɔ̃plo"	"monter-complot"
"montré"	"mɔ̃tʀe"	"montrer"
"montré 2"	"mɔ̃tʀe"	"montrer"
"mouché"	"muʃe"	"moucher"
"mouchté"	"muʃte"	"moucheter"
"moulé"	"mule"	"moudre"
"mousé"	"muse"	"mousser"
"mouvmanté"	"muvmɑ̃te"	"mouvement > mouvementer"
"mouyé"	"muje"	"mouiller"
"myolé"	"mjole"	"miauler"
"najé"	"naʒe"	"nager"
"nargé"	"naʀge"	"narguer"
"naté"	"nate"	"natter"
"néglijé"	"negliʒe"	"négliger"
"négosyé"	"negosjɑ̃"	"négocier"
"nétwayé"	"netwaje"	"nettoyer"
"néyé"	"neje"	"noyer"
"ni"	"ni"	"xxx"
"niché"	"niʃe"	"nicher"
"niméwoté"	"nimewote"	"numéro > numéroter"
"nonmé"	"nɔ̃me"	"nommer"
"nonmé 2"	"nɔ̃me"	"nommer"
"nonmé 3"	"nɔ̃me"	"nommer"
"nosé"	"nose"	"noce > nocer"
"noté"	"note"	"noter"
"nouri"	"nuʀi"	"nourrir"
"nwélé"	"nwεle"	"noël"
"nwèsi"	"nwεsi"	"noircir"
"obéyi"	"obeji"	"obéir"
"oblijé"	"obliʒe"	"obliger"
"òbsèrvé"	"ɔbsεʀve"	"observer"
"ofè"	"ofε"	"offrir"
"ofiramizi"	"ofiʀamizi"	"au-fur-et-à-mesure"
"ògmanté"	"ɔgmɑ̃te"	"augmenter"
"okazionné"	"okazjɔ̃ne"	"occasion > occasionner"
"okipé"	"okipe"	"occuper"
"opéré"	"opeʀe"	"opérer"
"opozé"	"opoze"	"opposer"
"òrganizé"	"ɔʀganize"	"organiser"
"oriyanté"	"oʀijɑ̃te"	"orienter"
"òrné"	"ɔʀne"	"orner"
"òspitalizé"	"ɔspitalize"	"hospitaliser"
"otorizé"	"otoʀize"	"autoriser"
"oubliyé"	"ublije"	"oublier"
"ouvè"	"uvε"	"ouvrir"
"ozé"	"oze"	"oser"
"padonné"	"padɔ̃ne"	"pardonner"
"palanké"	"palɑ̃ke"	"xxx"
"palé"	"pale"	"parler"
"palé gra"	"palegʀa"	"parler-gras"
"palpé"	"palpe"	"palper"
"panché"	"pɑ̃ʃe"	"pencher"
"panmé"	"pɑ̃me"	"pâmer"
"pann"	"pɑ̃n"	"pendre"
"pann 2"	"pɑ̃n"	"pendre"
"pansé"	"pɑ̃se"	"panser"
"pansé 2"	"pɑ̃se"	"penser"
"paradé"	"paʀade"	"parade > parader"
"paralizé"	"paʀalize"	"paralyser"
"paré 2"	"paʀe"	"parer"
"paré 3"	"paʀe"	"parer"
"parèt"	"paʀεt"	"paraître"
"parèt 2"	"paʀεt"	"paraître"
"parfimé"	"paʀfime"	"parfumer > parfum"
"partajé"	"paʀtaʒe"	"partager"
"pasé"	"pase"	"passer"
"pasé 2"	"pase"	"passer"
"pasé fyè"	"pasefjε"	"passer-fier"
"pasé-vwè"	"pasevwε"	"passer-voir"
"pasyanté"	"pasjɑ̃te"	"patienter"
"pasyonné"	"pasjɔ̃ne"	"passion > passionner"
"pati"	"pati"	"partir"
"patojé"	"patoʒe"	"patauger"
"patronné"	"patʀɔ̃ne"	"patron > patronner"
"pavwazé"	"pavwaze"	"pavoiser"
"payé"	"paje"	"pari > parier"
"payé 2"	"paje"	"xxx"
"pé"	"pe"	"pouvoir"
"pè"	"pɛ"	"peur"
"péché 2"	"peʃe"	"pêcher > pêche"
"pèd"	"pɛd"	"perdre"
"pédalé"	"pedale"	"pédale > pédaler"
"pèd-fòs"	"pɛdfɔs"	"perdre-force"
"pèd-lakat"	"pɛdlakat"	"perdre-carte"
"pengné"	"pɛ̃ɲe"	"peigner"
"pensé"	"pɛ̃se"	"pincer > pince !!!"
"pentiré"	"pɛ̃tiʀe"	"peindre"
"péplé"	"peple"	"peuple > peupler"
"pèrmèt"	"pεʀmεt"	"permettre"
"pèrsiyadé"	"pεɔ̃sijade"	"persuader"
"pèsé"	"pεse"	"percer"
"pèsé 2"	"pεse"	"percer"
"pèsé 3"	"pεse"	"percer"
"pèsivwè"	"pεsivwε"	"apercevoir"
"pèsté"	"pεste"	"peste > pester"
"pétayé"	"petaje"	"xxx"
"pété"	"pete"	"pet > péter"
"pété 2"	"pete"	"péter"
"pété 3"	"pete"	"péter"
"pétiyé"	"petije"	"pet > pétiller"
"pétri"	"petʀi"	"pétrir"
"péyé"	"peje"	"payer"
"pézé"	"peze"	"peser"
"pézé 2"	"peze"	"peser"
"piafé"	"pjafe"	"piaffer"
"pichonné"	"piʃɔ̃ne"	"pincher"
"pijé"	"piʒe"	"xxx"
"pijé 2"	"piʒe"	"xxx"
"pijé 3"	"piʒe"	"xxx"
"piké"	"pike"	"piquer"
"piké 3"	"pike"	"piquer"
"pikwaté"	"pikwate"	"xxx"
"pilé"	"pile"	"piler"
"pilé 2"	"pile"	"piler"
"pilé 3"	"pile"	"xxx"
"pililé"	"pilile"	"pulluler"
"pilonné cf pilé"	"pilɔ̃ne"	"pilon > pilonner"
"pimanté"	"pimɑ̃te"	"piment > pimenter"
"pini"	"pini"	"punir"
"pipé"	"pipe"	"xxx"
"pipé 2"	"pipe"	"piper"
"pipigné"	"pipiɲe"	"xxx"
"pisé"	"pise"	"pisser"
"pisimé var plisimé"	"pisimé"	"xxx"
"pistonné"	"pistɔ̃ne"	"piston > pistonner"
"pit"	"pit"	"xxx"
"pité"	"pite"	"pit (ang)    pit= fosse"
"piyé"	"pije"	"piller"
"plaké"	"plake"	"plaquer"
"planni"	"plɑ̃ni"	"xxx"
"planté"	"plɑ̃te"	"planter"
"plasé"	"plase"	"place > placer"
"plasé 2"	"plase"	"place > placer"
"plati"	"plati"	"plat > aplatir"
"platiné"	"platine"	"patiner"
"plè"	"plɛ"	"plaire"
"plédé"	"plede"	"plaider"
"plédé kòz"	"pledekɔz"	"plaider-cause"
"plenn"	"plɛ̃n"	"plaindre"
"pléré"	"pleʀe"	"pleurer"
"pléré gwodlo"	"pleʀegwodlo"	"pleurer-gros-eau"
"plézanté"	"plezɑ̃te"	"plaisanter"
"pliché"	"pliʃe"	"éplucher"
"pliché 2"	"pliʃe"	"xxx"
"pliché 3"	"pliʃe"	"xxx"
"plimé"	"plime"	"plumer"
"plisé"	"plise"	"plisser"
"plisimé cf pisimé"	"plisime"	"xxx"
"pliyé"	"plije"	"plier"
"ploké"	"ploke"	"xxx"
"plonjé"	"plɔ̃ʒe"	"plonger"
"plotonné"	"plotɔ̃ne"	"peloton > pelotonner"
"poli"	"poli"	"polir"
"pongné"	"pɔ̃ɲe"	"xxx"
"ponn"	"pɔ̃n"	"pondre"
"ponpé"	"pɔ̃pe"	"pomper"
"ponponné"	"pɔ̃pɔ̃ne"	"pomponner"
"ponsé"	"pɔ̃se"	"poncer"
"pòsté"	"pɔste"	"poste > poster"
"pòsté 2"	"pɔste"	"poster"
"pòté"	"pɔte"	"porter"
"pòté 2"	"pɔte"	"porter"
"pòté 3"	"pɔte"	"porter"
"pòté koko"	"pɔtekoko"	"porter"
"pòté mannèv"	"pɔtemɑ̃nεv"	"porter"
"poté on ganm"	"pɔteɔ̃gɑ̃m"	"porter"
"pòté pèt"	"pɔtepεt"	"porter-perte"
"pòtré"	"pɔtʀe"	"portrait"
"poudré"	"pudʀe"	"poudrer"
"pougalé"	"pugale"	"xxx"
"poupé"	"pupe"	"xxx"
"pouri 2"	"puʀi"	"pourrir"
"poursuiv var pousuiv"	"puʀsɥiv"	"poursuivre"
"pousé"	"puse"	"pousser"
"pousé 2"	"puse"	"pousser"
"pousuiv cf poursuiv"	"pusɥiv"	"poursuivre"
"pozé"	"poze"	"pause > pauser"
"pozé 2"	"poze"	"reposer"
"pran"	"pʀɑ̃"	"prendre"
"pran 2"	"pʀɑ̃"	"prendre"
"pran balan"	"pʀɑ̃balɑ̃"	"prendre"
"pran dlo"	"pʀɑ̃dlo"	"prendre-eau"
"pran douvan"	"pʀɑ̃duvɑ̃"	"prendre-devant"
"pran fè"	"pʀɑ̃fε"	"prendre-fer"
"pran fòs"	"pʀɑ̃fɔ̃s"	"prendre-force"
"pran gou"	"pʀɑ̃gu"	"prendre-goût"
"pran kondisyon"	"pʀɑ̃kɔ̃disjɔ̃"	"prendre-condition"
"pran kouri"	"pʀɑ̃kuʀi"	"prendre-courir"
"pran penn"	"pʀɑ̃pɛ̃n"	"prendre-peine"
"pran plon"	"pʀɑ̃plɔ̃"	"prendre-plomb"
"pran siren"	"pʀɑ̃siʀɛ̃"	"prendre-serein"
"préché"	"pʀeʃe"	"précher"
"prédi"	"pʀedi"	"prédire"
"préféré"	"pʀefeʀe"	"préférer"
"prémédité"	"premedite"	"préméditer"
"préparé"	"pʀepaʀe"	"préparer"
"présé"	"pʀese"	"presser"
"présé 2"	"pʀese"	"presser"
"prétann"	"pʀetɑ̃n"	"prétendre"
"prété"	"pʀete"	"prêter"
"prévwa"	"pʀevwa"	"prévoir"
"prévwa 2"	"pʀevwa"	"prévoir"
"prézanté"	"pʀezɑ̃te"	"présenter"
"prézidé"	"pʀezide"	"présider"
"primé"	"pʀime"	"prime >  primer"
"privé"	"pʀive"	"priver"
"priyé"	"pʀije"	"prier"
"priyédyé"	"pʀijedje"	"prier-Dieu"
"prizonné"	"pʀizɔ̃ne"	"prison > emprisonner"
"proché cf aproché"	"pʀoʃe"	"approcher"
"profité"	"profite"	"profiter"
"profité 2"	"pʀofite"	"profiter"
"progrésé"	"pʀogʀese"	"progrès > progresser"
"prokiré"	"pʀokiʀe"	"procurer"
"prokiré 2"	"pʀokiʀe"	"procurer"
"prolonjé"	"pʀolɔ̃ʒe"	"prolonger"
"promèt"	"pʀomɛt"	"promettre"
"pronmné"	"pʀɔ̃mne"	"promener"
"prononsé"	"pʀonɔ̃se"	"prononcer"
"propozé"	"pʀopoze"	"proposer"
"pròspéré"	"pʀɔspeʀe"	"prospérer"
"protéjé"	"pʀoteʒe"	"protéger"
"protèsté"	"pʀotεste"	"protester"
"prouvé"	"pʀuve"	"prouver"
"pwagnadé"	"pwaɲade"	"poignard > poignarder"
"pwayé"	"plojé"	"ployer"
"pwazonné cf anpwa…."	"pwazɔ̃ne"	"poison > empoisonner"
"pwenté"	"pwɛ̃te"	"point > pointer"
"pwòpté"	"pwɔpte"	"propre"
"pyèsté"	"pjεste"	"rapiécer"
"pyété"	"pjete"	"xxx"
"pyoché"	"pjoʃe"	"pioche > piocher"
"rabaché"	"ʀabaʃe"	"rabâcher"
"raboté"	"ʀabote"	"rabot > raboter"
"rabouté"	"ʀabute"	"rabouter"
"raché"	"ʀaʃe"	"arracher"
"rachté"	"ʀaʃte"	"racheter"
"radoté"	"ʀadote"	"radoter"
"raflé"	"ʀafle"	"rafler"
"raflé 2"	"ʀafle"	"rafler"
"rafréchi"	"ʀafʀeʃi"	"rafraîchir"
"rajéni"	"ʀaʒeni"	"jeune > rajeunir"
"rajouté"	"ʀaʒute"	"ajouter > rajouter"
"rakasiyé"	"ʀakasije"	"xxx"
"rakomodé"	"ʀakomode"	"raccommoder"
"rakonpagné"	"ʀakɔ̃paɲe"	"accompagner> raccompagner"
"rakonté"	"ʀakɔ̃te"	"raconter"
"rakouri"	"ʀakuʀi"	"xxx"
"rakousi"	"ʀakusi"	"raccourcir"
"ralanti"	"ʀalɑ̃ti"	"ralentir"
"ralé"	"ʀale"	"haler"
"ralonjé"	"ʀalɔ̃ʒe"	"rallonger"
"ramoli"	"ʀamoli"	"ramollir"
"ranboulé"	"ʀɑ̃bule"	"xxx"
"ranbousé"	"ʀɑ̃buse"	"rembourser"
"ranjé"	"ʀɑ̃ʒe"	"ranger"
"ranjé 2"	"ʀɑ̃ʒe"	"arranger"
"rankontré var kontré"	"ʀɑ̃kɔ̃tʀe"	"rencontrer"
"ranmasé"	"ʀɑ̃mase"	"ramasser"
"ranmasé 2"	"ʀɑ̃mase"	"ramasser"
"ranmé"	"ʀɑ̃me"	"ramer"
"ranmé 2"	"ʀɑ̃me"	"rame"
"rann"	"ʀɑ̃n"	"rendre"
"rann 2"	"ʀɑ̃n"	"rendre"
"ranpé"	"ʀɑ̃pe"	"ramper"
"ranplasé"	"ʀɑ̃plase"	"remplacer"
"ranpli"	"ʀɑ̃pli"	"remplir"
"ranségné"	"ʀɑ̃seɲe"	"renseigner"
"ransi"	"ʀɑ̃si"	"rancir"
"rantré"	"ʀɑ̃tʀe"	"rentrer"
"rapé"	"ʀape"	"raper"
"raplanni"	"ʀaplɑ̃ni"	"aplanir"
"rapòté"	"ʀapɔte"	"rapporter"
"rapòté 2"	"ʀapɔte"	"rapporter"
"raproché"	"ʀapwoʃe"	"rapprocher"
"rapyanné"	"ʀapjɑ̃ne"	"xxx"
"rapyèsté"	"ʀapjɛste"	"rapièceter"
"rasanblé"	"ʀasɑ̃ble"	"rassembler"
"rasazié"	"ʀasazje"	"rassasier"
"raté"	"ʀate"	"rater"
"ratrapé"	"ʀatʀape"	"rattraper"
"ravajé"	"ʀavaʒe"	"ravage > ravager"
"ravitayé"	"ʀavitaje"	"ravitailler"
"ray"	"ʀaj"	"haïr"
"razé"	"ʀaze"	"raser"
"rèbondi"	"ʀεbɔdi"	"rebondir"
"réchapé"	"ʀeʃape"	"réchapper"
"réchofé"	"ʀeʃofe"	"réchauffer"
"rédé"	"ʀede"	"aider"
"rédi"	"ʀedi"	"raide > raidir"
"rèdi"	"ʀεdi"	"dire > redire"
"rédi 2"	"ʀedi"	"raide > raidir"
"rédi 3"	"ʀedi"	"raide > raidir"
"rédi 4"	"ʀedi"	"raide > raidir"
"rèdoublé var doublé"	"ʀeduble"	"doubler > redoubler"
"rèfizé"	"ʀεfize"	"refuser"
"réfléchi"	"ʀefleʃi"	"réfléchir"
"rèfwadi"	"ʀεfwadi"	"froid > refroidir"
"réglé"	"ʀegle"	"règle > régler"
"réglé 2"	"ʀegle"	"règle > régler"
"règrété"	"ʀεgʀete"	"regretter"
"rèkilé"	"ʀɛkile"	"reculer"
"rékizisyonné"	"ʀekizisjɔ̃ne"	"réquisition > réquisitionner"
"réklamé"	"ʀeklame"	"réclamer"
"rékòlté"	"ʀekɔlte"	"réclamer"
"rèkonmansé cf wou…"	"ʀεkɔ̃mɑ̃se"	"commencer > recommencer"
"rèkonnèt"	"ʀεkɔ̃nεt"	"connaître > reconnaître"
"rékonpansé"	"ʀekɔ̃pɑ̃se"	"récompenser"
"rèkopyé"	"ʀεkopje"	"copier > recopier"
"rèlèvé"	"ʀεlεve"	"relever"
"rèlévé konvèsyon"	"levekɔ̃vεsjɔ̃"	"xxx"
"rèmarké"	"ʀεmaʀke"	"marquer > remarquer"
"rèmèt"	"ʀεmεt"	"remettre"
"rènaklé"	"ʀεnakle"	"renâcler"
"rensé"	"ʀɛ̃se"	"rincer"
"rènyé"	"ʀεnje"	"renier"
"réparé"	"ʀepaʀe"	"réparer"
"rèpasé"	"ʀεpase"	"repasser"
"répigné"	"ʀepiɲe"	"répugner"
"répliké"	"ʀeplike"	"répliquer"
"rèpo"	"ʀεpo"	"repos"
"réponn"	"ʀepɔ̃n"	"répondre"
"rèpozé"	"ʀεpoze"	"reposer > repos"
"rèproché"	"ʀεpʀoʃe"	"reprocher"
"rèsasé"	"ʀεsase"	"ressasser"
"résidivé"	"ʀesidive"	"recidiver"
"résisité"	"ʀeziste"	"ressusciter"
"résité"	"ʀesite"	"réciter"
"rèskiyé"	"ʀεskije"	"resquiller"
"rèspèkté"	"ʀεspεkte"	"respecter"
"rèspiré"	"ʀεspiʀe"	"respirer"
"rèswa"	"ʀεswa"	"recevoir"
"rètardé"	"ʀεtaʀde"	"retarder"
"rété"	"ʀete"	"rester"
"rété 2"	"ʀete"	"rester"
"rètouné cf woutouné"	"ʀεtune"	"retourner"
"rétrési"	"ʀetʀesi"	"retrécir"
"rètrousé"	"ʀεtʀuse"	"retrousser"
"rètyenn"	"ʀεtjɛ̃n"	"retenir"
"rètyenn 2"	"ʀεtjɛ̃n"	"retenir"
"rèvann"	"ʀεvãn"	"vendre > revendre"
"révasé"	"ʀevase"	"révasser"
"révé"	"ʀeve"	"rêver"
"révéyonné"	"ʀevejɔ̃ne"	"réveillon > réveillonner"
"rèviv"	"ʀεviv"	"vivre > revivre"
"révizé"	"ʀevize"	"réviser"
"réyaji"	"ʀejaʒi"	"réagir"
"réyé"	"ʀeje"	"rayer"
"réyisi"	"ʀejisi"	"réussir"
"rézèrvé"	"ʀezεʀve"	"réserver"
"rézisté"	"ʀeziste"	"résister"
"rézonné"	"ʀezɔ̃ne"	"résonner"
"rézonné 2"	"ʀezɔ̃ne"	"raisonner"
"rézonné 3"	"ʀezɔ̃ne"	"raisonner"
"rézoud"	"ʀezud"	"résoudre"
"ri"	"ʀi"	"rire"
"rigolé"	"ʀigole"	"rigoler"
"rikanné"	"ʀikɑ̃ne"	"ricaner"
"rimé"	"ʀime"	"remuer"
"riské"	"ʀiske"	"risquer"
"rivé"	"ʀive"	"arriver"
"sa"	"sa"	"savoir"
"sakrifyé"	"sakʀifje"	"sacrifier"
"salé"	"sale"	"saler"
"Sali"	"Sali"	"salir"
"salonné"	"salɔ̃ne"	"salon >salonner"
"salòpté"	"salɔpte"	"saloper"
"sanblé cf rasanblé"	"sɑ̃ble"	"rassembler"
"sanglé"	"sɑ̃gle"	"sangle > sangler"
"sanm"	"sɑ̃m"	"ressembler"
"sanm 2"	"sɑ̃m"	"sembler"
"santi"	"sɑ̃ti"	"sentir"
"sapé"	"sɑpe"	"xxx"
"sav var savé"	"sav"	"savoir"
"savé cf sav"	"save"	"savoir"
"savonné"	"savɔ̃né"	"savon > savonner"
"sé 2"	"se"	"être"
"séché"	"seʃe"	"sécher"
"sèklé"	"sεkle"	"sarcler"
"sélé"	"sele"	"sceller"
"sélébré"	"selebʀe"	"célébrer"
"sendiké"	"sɛ̃dike"	"syndic > syndiquer"
"sengné"	"sɛ̃ɲe"	"saigner"
"sentré"	"sɛ̃tʀe"	"cintrer"
"séparé"	"sepaʀe"	"séparer"
"séparé 2"	"sepaʀe"	"séparer"
"séré"	"seʀe"	"serrer"
"séré 2"	"seʀe"	"serrer (sens picard)"
"séré 3"	"seʀe"	"serrer"
"sèrvitid"	"sεʀvitid"	"servitude"
"sèvi"	"sεvi"	"servir"
"sévré"	"sevʀe"	"sevrer"
"sézi"	"sezi"	"saisir"
"sézi 2"	"sezi"	"saisir"
"sibi"	"sibi"	"subir"
"sifi"	"sifi"	"suffire"
"siflé"	"sifle"	"siffler"
"sifoké"	"sifoke"	"suffoquer"
"sifonné"	"sifɔ̃ne"	"siphon > siphonner"
"signé"	"siɲe"	"signer"
"signifyé"	"siɲifje"	"signifier"
"sikré"	"sikʀe"	"sucrer"
"simanté"	"simɑ̃te"	"ciment > cimenter"
"simé 2"	"sime"	"semer"
"sipé"	"sipe"	"xxx"
"sipliyé"	"siplije"	"supplier"
"sipòté 2"	"sipɔte"	"supporter"
"sipozé"	"sipoze"	"supposer"
"siprimé"	"sipʀime"	"supprimer"
"siré"	"siʀe"	"cirer"
"sirfilé"	"siʀfile"	"surfiler"
"siri"	"siʀi"	"surir"
"sirnonmé"	"siʀnɔ̃me"	"surnom > surnommer"
"sirprann"	"siʀpʀɑ̃n"	"surprendre"
"sirsoté"	"siʀsote"	"sursauter"
"sirvéyé"	"siʀveje"	"surveiller"
"sisit"	"sisit"	"sissite (même sens en picard)"
"sispann"	"sispɑ̃n"	"suspendre"
"sitronné"	"sitʀɔ̃ne"	"citron"
"siwoté"	"siwote"	"sirop > siroter"
"siyé"	"sije"	"scier"
"siyonné"	"sijɔ̃ne"	"sillon > sillonner"
"sizé"	"size"	"xxx"
"sòldé"	"sɔlde"	"solde > solder"
"sondé"	"sɔ̃de"	"sonder"
"sonjé"	"sɔ̃ʒe"	"songer"
"sonné"	"sɔ̃ne"	"sonner"
"soré"	"soʀe"	"essorer"
"sosé"	"sose"	"sauce > saucer"
"soté"	"sote"	"sauter"
"soté 2"	"sote"	"sursauter"
"sòti"	"sɔti"	"sortir"
"soudé"	"sude"	"souder"
"soufè"	"sufε"	"souffrir"
"souflé"	"sufle"	"souffler"
"souhaché"	"suhaʃe"	"xxx"
"soukwé"	"sukwe"	"secouer"
"soulajé"	"sulaʒe"	"soulager"
"soulé"	"sule"	"saouler"
"souligné"	"suliɲe"	"souligner"
"soulyété"	"suljete"	"soulier"
"soupé"	"supe"	"souper"
"soupézé"	"supeze"	"peser > soupeser"
"soupiré"	"supiʀe"	"soupirer"
"soupsonné"	"supsɔ̃ne"	"soupçonner"
"souri"	"suri"	"sourire"
"sousé"	"suse"	"sucer"
"sousyé"	"susje"	"soucier"
"soutiré"	"sutiʀe"	"tirer > soutirer"
"soutyenn"	"sutjɛ̃n"	"soutenir"
"sové"	"sove"	"sauver"
"stasyonné"	"stasjɔ̃ne"	"stationner"
"stoké"	"stoké"	"stocker"
"suifé"	"sɥife"	"suifer"
"suiv"	"sɥiv"	"suivre"
"suiyé"	"sɥije"	"essuyer"
"swagné"	"swaɲe"	"soigner"
"swé"	"swe"	"suer"
"swenté"	"swɛ̃te"	"suinter"
"swété"	"swete"	"souhaiter"
"syéjé"	"sjeʒe"	"siège > siéger"
"tablé"	"table"	"tabler"
"tablé 2"	"table"	"attabler"
"taché"	"taʃe"	"attacher"
"taché 2"	"taʃe"	"tacher"
"tadé"	"tade"	"tarder"
"takiné"	"takine"	"taquiner"
"taklé"	"takle"	"tackle (ang)"
"tanbouriné"	"tɑ̃buʀine"	"tambourin > tambouriner"
"tandé cf tann"	"tɑ̃de"	"xxx"
"tangé"	"tɑ̃ge"	"tanguer"
"tanmizé"	"tɑ̃mize"	"tamiser"
"tann"	"tɑ̃n"	"entendre"
"tann 2"	"tɑ̃n"	"étendre"
"tanné"	"tɑ̃ne"	"tanner"
"tanné 2"	"tɑ̃ne"	"tanner"
"tanpé"	"tɑ̃pe"	"xxx"
"tanpété"	"tɑ̃pete"	"tempête > tempêter"
"tanporizé"	"tɑ̃poʀize"	"temporiser"
"tansé"	"tɑ̃se"	"tancer"
"tanté"	"tɑ̃te"	"tenter"
"tanté 2"	"tɑ̃te"	"tenter"
"tapé"	"tape"	"taper"
"tapé 2"	"tape"	"taper"
"tasé"	"tase"	"tas > tasser"
"taté"	"tate"	"tâter"
"tatonné"	"tatɔ̃ne"	"tâtonner"
"tatwé"	"tatwe"	"tatouer"
"tawaché"	"tawaʃe"	"xxx"
"tayé"	"taje"	"tailler"
"tchansé cf kyansé"	"tʃɑ̃se"	"xxx"
"tchèk"	"tʃεk"	"xxx"
"tchèk 2"	"tʃεk"	"xxx"
"tchèk 3"	"tʃεk"	"xxx"
"tchèk 4"	"tʃεk"	"xxx"
"tchenbé"	"tʃɛ̃be"	"xxx"
"tchoké"	"tʃoke"	"xxx"
"téléfonné"	"telefɔ̃ne"	"téléphone > téléphoner"
"tenn"	"tɛ̃n"	"teindre"
"tèrbolizé"	"tεʀbolize"	"xxx"
"téré cf antéré"	"teʀe"	"terre > enterrer"
"tèsté"	"tεste"	"xxx"
"tèsté 2"	"tεste"	"tester"
"tété 2"	"tete"	"têter"
"tijé"	"tiʒe"	"tige"
"tijé 2"	"tiʒe"	"tige"
"tin"	"tin"	"xxx"
"tini"	"tini"	"xxx"
"tiré"	"tiʀe"	"tirer"
"tiré 2"	"tiʀe"	"tirer"
"tiré 3"	"tiʀe"	"tirer"
"tiré 4"	"tiʀe"	"tirer > retirer"
"tiré plan"	"tireplɑ̃"	"tirer"
"titibé"	"titibe"	"tituber"
"tiyé"	"tije"	"étriller"
"tiyé 2"	"tije"	"xxx"
"tizi"	"tizi"	"phtisie"
"tizonné"	"tizɔ̃ne"	"xxx"
"tòd"	"tɔd"	"tordre"
"tòk"	"tɔk"	"xxx"
"tonbé"	"tɔ̃be"	"tomber"
"tonbé léta"	"tɔ̃beleta"	"tomber"
"tonn"	"tɔ̃n"	"tondre"
"tòtòy"	"tɔtɔy"	"xxx"
"touché"	"tuʃe"	"toucher"
"toudi"	"tudi"	"étourdir"
"toufé"	"tufé"	"étouffer"
"toufé 2"	"tufe"	"étouffer"
"touné"	"tune"	"tourner"
"touné 2"	"tune"	"tourner"
"touné-viré"	"tuneviʀe"	"tournevirer(vx)fr mouvoir qqch"
"tousé"	"tuse"	"tousser"
"touvé"	"tuve"	"trouver"
"touwmanté"	"tuwmɑ̃te"	"tourmenter"
"trafiké"	"tʀafike"	"trafiquer >trafic"
"trakasé"	"tʀakase"	"tracasser"
"tranblé"	"tʀɑ̃ble"	"trembler"
"tranché"	"tʀɑ̃ʃe"	"trancher > tranche"
"tranglé"	"tʀɑ̃gle"	"étrangler"
"trankilizé"	"tʀɑ̃kilize"	"tranquille > tranquilliser"
"tranpé"	"tʀɑ̃pe"	"tremper"
"transplanté"	"tʀɑ̃splɑ̃te"	"transplanter"
"transvazé"	"tʀɑ̃svaze"	"transvaser"
"transvidé"	"tʀɑ̃svide"	"transvider"
"trapé"	"tʀape"	"attraper"
"trapé tren"	"tʀapetʀɛ̃"	"attraper"
"trasé"	"tʀase"	"tracer"
"trasé 2"	"tʀase"	"tracer"
"travay"	"tʀavaj"	"travailler"
"travèsé"	"tʀavεse"	"traverser"
"trayi"	"tʀaji"	"trahir"
"trè 5"	"tʀε"	"traire"
"trenbalé"	"tʀɛ̃bale"	"trimbaler"
"trenké"	"tʀɛ̃ke"	"trinquer"
"trenné"	"tʀɛ̃ne"	"traîner"
"trépanné"	"tʀepɑ̃ne"	"trépaner"
"trépigné"	"tʀepiɲe"	"trépigner"
"trésayi"	"tʀesaji"	"trésaillir"
"trésé"	"tʀese"	"tresse > tresser"
"trété"	"tʀete"	"traiter"
"trété 2"	"tʀete"	"traiter"
"tribiché"	"tʀibiʃe"	"trébucher"
"triché"	"tʀiʃe"	"tricher"
"trikoté"	"tʀikote"	"tricot > tricoter"
"trimé"	"tʀime"	"trimer"
"triplé"	"tʀiple"	"tripler"
"triviyé"	"tʀivije"	"xxx"
"triyé"	"tʀije"	"trier"
"tronné"	"tʀɔ̃ne"	"trôner"
"tronpé"	"tʀɔ̃pe"	"tromper"
"tronpété"	"tʀɔ̃pete"	"trompette > trompeter"
"twalété"	"twalete"	"toilette > toiletter"
"twazé"	"twaze"	"toiser"
"tyédi"	"tjedi"	"tiède > tiédir"
"vaksiné"	"vaksine"	"vacciner"
"valdengé"	"valdɛ̃ge"	"valdinguer"
"valé cf anvalé"	"vale"	"avaler"
"valsé"	"valse"	"valser"
"vann"	"vãn"	"vendre"
"vanné"	"vãne"	"vanner"
"vansé cf avansé"	"vãse"	"avancer"
"vanté"	"vãte"	"vanter"
"vanté 2"	"vãte"	"éventer"
"vanté 3"	"vãte"	"éventer"
"vanté 4"	"vãte"	"vent > venter"
"varé"	"vaʀe"	"xxx"
"varé 2"	"vaʀe"	"xxx"
"vé cf vlé"	"ve"	"vouloir"
"vèglé"	"vεgle"	"aveugler"
"véjété"	"veʒete"	"végéter"
"vèksé"	"vεkse"	"vexer"
"vèrbalizé"	"vεʀbalize"	"verbaliser"
"vérifyé"	"veʀifje"	"vérifier"
"vèrni"	"vεʀni"	"vernir"
"vèsté"	"vεste"	"veste"
"véyé"	"veje"	"veiller"
"vidanjé"	"vidãʒe"	"vidange > vidanger"
"vidé"	"vide"	"vider"
"vin"	"vin"	"venir"
"vin 2"	"vin"	"venir"
"vin-di"	"vindi"	"venir-dire"
"vini"	"vini"	"venir"
"viré"	"viʀe"	"virer"
"viré 2"	"viʀe"	"virer"
"viré-désann"	"viʀedesãn"	"virer"
"viré-do"	"viʀedo"	"virer"
"viré-monté"	"viʀemɔ̃te"	"virer"
"viré-pòté"	"viʀepɔte"	"virer-porter"
"visé"	"vise"	"visser"
"viv"	"viv"	"vivre"
"vizé"	"vize"	"viser"
"vizité"	"vizite"	"visiter"
"vlé var vé"	"vle"	"vouloir"
"vlopé"	"vlope"	"envelopper"
"vo"	"vo"	"valoir"
"volé"	"vole"	"voler"
"volé 2"	"vole"	"voler"
"vòlkannizé"	"vɔlkãnize"	"volcan"
"vòltijé"	"vɔltiʒe"	"voltiger"
"vonmi"	"vɔ̃mi"	"vomir"
"vonvonné"	"vɔ̃vɔ̃ne"	"xxx"
"voté"	"vote"	"voter"
"votré"	"votʀe"	"vautrer"
"voyé"	"voje"	"envoyer"
"voyé alé"	"vojeale"	"envoyer-aller"
"voyé labou"	"vojelabu"	"envoyer-boue"
"voyé mépri"	"vojemepʀi"	"envoyer"
"voyé zyé"	"vojezje"	"envoyer-yeux"
"voyé-di"	"vojedi"	"envoyer-dire"
"vwayajé"	"vwajaʒe"	"voyager"
"vwè"	"vwε"	"voir"
"vyéyi"	"vjeji"	"vieillir"
"vyolé"	"vjole"	"violer"
"waché"	"waʃe"	"xxx"
"waché 2"	"waʃe"	"xxx"
"wapé cf japé"	"wape"	"japper"
"watché"	"watʃe"	"xxx"
"wayiné"	"wajine"	"xxx"
"wodé"	"wode"	"rôder"
"wonchonné"	"wɔ̃ʃɔ̃ne"	"ronchonner"
"wondi"	"wɔ̃di"	"rond"
"wonflé"	"wɔ̃fle"	"ronfler"
"wongné"	"wɔ̃ɲe"	"rogner"
"wonpi"	"wɔ̃pi"	"rompre"
"wont"	"wɔ̃t"	"honte"
"wonwonné"	"wɔ̃wɔ̃ne"	"ronronner"
"wosé"	"wose"	"hausser"
"woté"	"wote"	"ôter"
"woté 2"	"wote"	"rôter"
"woti"	"woti"	"rotir"
"wotiné"	"wotine"	"rotin"
"woubat"	"wubat"	"battre > rebattre"
"woubay"	"wubaj"	"xxx"
"wouklé"	"wukle"	"xxx"
"woukonmansé var rèk.."	"wukɔ̃mɑ̃se"	"commencer > recommencer"
"woukoulé"	"wukule"	"roucouler"
"woulé 3"	"wule"	"rouler"
"woulé 4"	"wule"	"rouler"
"woumandé"	"wumɑ̃de"	"demander > redemander"
"woupasé"	"wupase"	"passer > repasser"
"woupati"	"wupati"	"partir > repartir"
"wouplanté"	"wuplɑ̃te"	"planter > replanter"
"woupran"	"wupʀɑ̃"	"prendre > reprendre"
"wousi"	"wusi"	"roussir"
"wousoulé"	"wusule"	"receler"
"wousouvwè"	"wusuvwε"	"recevoir"
"wouspété"	"wuspete"	"rouspéter"
"woutouné"	"wutune"	"tourner > retourner"
"wouvè var ouvè"	"wuvε"	"ouvrir"
"wouvin var wouvini"	"wuvin"	"venir > revenir"
"wouvini cf wouvin"	"wuvini"	"venir > revenir"
"wouvwè"	"wuvwε"	"voir > revoir"
"wouzé cf wozé"	"wuze"	"arroser"
"wouziné"	"wuzine"	"xxx"
"wozé var wouzé"	"woze"	"arroser"
"yé"	"je"	"xxx"
"zagalé"	"zagale"	"xxx"
"zenglété"	"zɛ̃ŋglete"	"xxx"
"zigé"	"zige"	"xxx"
"zigzagé"	"zigzage"	"zigzag > zigzaguer"
"zingé cf zigé"	"ziŋge"	"xxx"
"zinglété cf zenglété"	"ziŋglete"	"xxx"
"zouké"	"zuke"	"xxx"
"zyété"	"zjete"	"yeux > zyeuter"
